task_name	dataset_name	subset_name	template_name
adversarial_qa_dbert_answer_the_following_q	adversarial_qa	dbert	answer_the_following_q
adversarial_qa_dbert_answer_the_following_q_score_eval	adversarial_qa	dbert	answer_the_following_q_score_eval
adversarial_qa_dbert_based_on	adversarial_qa	dbert	based_on
adversarial_qa_dbert_based_on_score_eval	adversarial_qa	dbert	based_on_score_eval
adversarial_qa_dbert_generate_question	adversarial_qa	dbert	generate_question
adversarial_qa_dbert_generate_question_score_eval	adversarial_qa	dbert	generate_question_score_eval
adversarial_qa_dbert_question_context_answer	adversarial_qa	dbert	question_context_answer
adversarial_qa_dbert_question_context_answer_score_eval	adversarial_qa	dbert	question_context_answer_score_eval
adversarial_qa_dbert_tell_what_it_is	adversarial_qa	dbert	tell_what_it_is
adversarial_qa_dbert_tell_what_it_is_score_eval	adversarial_qa	dbert	tell_what_it_is_score_eval
adversarial_qa_dbidaf_answer_the_following_q	adversarial_qa	dbidaf	answer_the_following_q
adversarial_qa_dbidaf_answer_the_following_q_score_eval	adversarial_qa	dbidaf	answer_the_following_q_score_eval
adversarial_qa_dbidaf_based_on	adversarial_qa	dbidaf	based_on
adversarial_qa_dbidaf_based_on_score_eval	adversarial_qa	dbidaf	based_on_score_eval
adversarial_qa_dbidaf_generate_question	adversarial_qa	dbidaf	generate_question
adversarial_qa_dbidaf_generate_question_score_eval	adversarial_qa	dbidaf	generate_question_score_eval
adversarial_qa_dbidaf_question_context_answer	adversarial_qa	dbidaf	question_context_answer
adversarial_qa_dbidaf_question_context_answer_score_eval	adversarial_qa	dbidaf	question_context_answer_score_eval
adversarial_qa_dbidaf_tell_what_it_is	adversarial_qa	dbidaf	tell_what_it_is
adversarial_qa_dbidaf_tell_what_it_is_score_eval	adversarial_qa	dbidaf	tell_what_it_is_score_eval
adversarial_qa_droberta_answer_the_following_q	adversarial_qa	droberta	answer_the_following_q
adversarial_qa_droberta_answer_the_following_q_score_eval	adversarial_qa	droberta	answer_the_following_q_score_eval
adversarial_qa_droberta_based_on	adversarial_qa	droberta	based_on
adversarial_qa_droberta_based_on_score_eval	adversarial_qa	droberta	based_on_score_eval
adversarial_qa_droberta_generate_question	adversarial_qa	droberta	generate_question
adversarial_qa_droberta_generate_question_score_eval	adversarial_qa	droberta	generate_question_score_eval
adversarial_qa_droberta_question_context_answer	adversarial_qa	droberta	question_context_answer
adversarial_qa_droberta_question_context_answer_score_eval	adversarial_qa	droberta	question_context_answer_score_eval
adversarial_qa_droberta_tell_what_it_is	adversarial_qa	droberta	tell_what_it_is
adversarial_qa_droberta_tell_what_it_is_score_eval	adversarial_qa	droberta	tell_what_it_is_score_eval
ag_news_classify	ag_news		classify
ag_news_classify_question_first	ag_news		classify_question_first
ag_news_classify_question_first_score_eval	ag_news		classify_question_first_score_eval
ag_news_classify_score_eval	ag_news		classify_score_eval
ag_news_classify_with_choices	ag_news		classify_with_choices
ag_news_classify_with_choices_question_first	ag_news		classify_with_choices_question_first
ag_news_classify_with_choices_question_first_score_eval	ag_news		classify_with_choices_question_first_score_eval
ag_news_classify_with_choices_score_eval	ag_news		classify_with_choices_score_eval
ag_news_recommend	ag_news		recommend
ag_news_recommend_score_eval	ag_news		recommend_score_eval
ag_news_which_section	ag_news		which_section
ag_news_which_section_choices	ag_news		which_section_choices
ag_news_which_section_choices_score_eval	ag_news		which_section_choices_score_eval
ag_news_which_section_score_eval	ag_news		which_section_score_eval
ai2_arc_ARC_Challenge_heres_a_problem	ai2_arc	ARC-Challenge	heres_a_problem
ai2_arc_ARC_Challenge_heres_a_problem_score_eval	ai2_arc	ARC-Challenge	heres_a_problem_score_eval
ai2_arc_ARC_Challenge_i_am_hesitating	ai2_arc	ARC-Challenge	i_am_hesitating
ai2_arc_ARC_Challenge_i_am_hesitating_score_eval	ai2_arc	ARC-Challenge	i_am_hesitating_score_eval
ai2_arc_ARC_Challenge_multiple_choice	ai2_arc	ARC-Challenge	multiple_choice
ai2_arc_ARC_Challenge_multiple_choice_score_eval	ai2_arc	ARC-Challenge	multiple_choice_score_eval
ai2_arc_ARC_Challenge_pick_false_options	ai2_arc	ARC-Challenge	pick_false_options
ai2_arc_ARC_Challenge_pick_false_options_score_eval	ai2_arc	ARC-Challenge	pick_false_options_score_eval
ai2_arc_ARC_Challenge_pick_the_most_correct_option	ai2_arc	ARC-Challenge	pick_the_most_correct_option
ai2_arc_ARC_Challenge_pick_the_most_correct_option_score_eval	ai2_arc	ARC-Challenge	pick_the_most_correct_option_score_eval
ai2_arc_ARC_Challenge_qa_options	ai2_arc	ARC-Challenge	qa_options
ai2_arc_ARC_Challenge_qa_options_score_eval	ai2_arc	ARC-Challenge	qa_options_score_eval
ai2_arc_ARC_Easy_heres_a_problem	ai2_arc	ARC-Easy	heres_a_problem
ai2_arc_ARC_Easy_heres_a_problem_score_eval	ai2_arc	ARC-Easy	heres_a_problem_score_eval
ai2_arc_ARC_Easy_i_am_hesitating	ai2_arc	ARC-Easy	i_am_hesitating
ai2_arc_ARC_Easy_i_am_hesitating_score_eval	ai2_arc	ARC-Easy	i_am_hesitating_score_eval
ai2_arc_ARC_Easy_multiple_choice	ai2_arc	ARC-Easy	multiple_choice
ai2_arc_ARC_Easy_multiple_choice_score_eval	ai2_arc	ARC-Easy	multiple_choice_score_eval
ai2_arc_ARC_Easy_pick_false_options	ai2_arc	ARC-Easy	pick_false_options
ai2_arc_ARC_Easy_pick_false_options_score_eval	ai2_arc	ARC-Easy	pick_false_options_score_eval
ai2_arc_ARC_Easy_pick_the_most_correct_option	ai2_arc	ARC-Easy	pick_the_most_correct_option
ai2_arc_ARC_Easy_pick_the_most_correct_option_score_eval	ai2_arc	ARC-Easy	pick_the_most_correct_option_score_eval
ai2_arc_ARC_Easy_qa_options	ai2_arc	ARC-Easy	qa_options
ai2_arc_ARC_Easy_qa_options_score_eval	ai2_arc	ARC-Easy	qa_options_score_eval
amazon_polarity_Is_this_product_review_positive	amazon_polarity		Is_this_product_review_positive
amazon_polarity_Is_this_product_review_positive_score_eval	amazon_polarity		Is_this_product_review_positive_score_eval
amazon_polarity_Is_this_review	amazon_polarity		Is_this_review
amazon_polarity_Is_this_review_negative	amazon_polarity		Is_this_review_negative
amazon_polarity_Is_this_review_negative_score_eval	amazon_polarity		Is_this_review_negative_score_eval
amazon_polarity_Is_this_review_score_eval	amazon_polarity		Is_this_review_score_eval
amazon_polarity_User_recommend_this_product	amazon_polarity		User_recommend_this_product
amazon_polarity_User_recommend_this_product_score_eval	amazon_polarity		User_recommend_this_product_score_eval
amazon_polarity_convey_negative_or_positive_sentiment	amazon_polarity		convey_negative_or_positive_sentiment
amazon_polarity_convey_negative_or_positive_sentiment_score_eval	amazon_polarity		convey_negative_or_positive_sentiment_score_eval
amazon_polarity_flattering_or_not	amazon_polarity		flattering_or_not
amazon_polarity_flattering_or_not_score_eval	amazon_polarity		flattering_or_not_score_eval
amazon_polarity_negative_or_positive_tone	amazon_polarity		negative_or_positive_tone
amazon_polarity_negative_or_positive_tone_score_eval	amazon_polarity		negative_or_positive_tone_score_eval
amazon_polarity_user_satisfied	amazon_polarity		user_satisfied
amazon_polarity_user_satisfied_score_eval	amazon_polarity		user_satisfied_score_eval
amazon_polarity_would_you_buy	amazon_polarity		would_you_buy
amazon_polarity_would_you_buy_score_eval	amazon_polarity		would_you_buy_score_eval
anli_GPT_3_style_r1	anli	r1	GPT-3 style
anli_GPT_3_style_r1_score_eval	anli	r1	GPT-3 style_score_eval
anli_GPT_3_style_r2	anli	r2	GPT-3 style
anli_GPT_3_style_r2_score_eval	anli	r2	GPT-3 style_score_eval
anli_GPT_3_style_r3	anli	r3	GPT-3 style
anli_GPT_3_style_r3_score_eval	anli	r3	GPT-3 style_score_eval
anli_MNLI_crowdsource_r1	anli	r1	MNLI crowdsource
anli_MNLI_crowdsource_r1_score_eval	anli	r1	MNLI crowdsource_score_eval
anli_MNLI_crowdsource_r2	anli	r2	MNLI crowdsource
anli_MNLI_crowdsource_r2_score_eval	anli	r2	MNLI crowdsource_score_eval
anli_MNLI_crowdsource_r3	anli	r3	MNLI crowdsource
anli_MNLI_crowdsource_r3_score_eval	anli	r3	MNLI crowdsource_score_eval
anli_always_sometimes_never_r1	anli	r1	always/sometimes/never
anli_always_sometimes_never_r1_score_eval	anli	r1	always/sometimes/never_score_eval
anli_always_sometimes_never_r2	anli	r2	always/sometimes/never
anli_always_sometimes_never_r2_score_eval	anli	r2	always/sometimes/never_score_eval
anli_always_sometimes_never_r3	anli	r3	always/sometimes/never
anli_always_sometimes_never_r3_score_eval	anli	r3	always/sometimes/never_score_eval
anli_based_on_the_previous_passage_r1	anli	r1	based on the previous passage
anli_based_on_the_previous_passage_r1_score_eval	anli	r1	based on the previous passage_score_eval
anli_based_on_the_previous_passage_r2	anli	r2	based on the previous passage
anli_based_on_the_previous_passage_r2_score_eval	anli	r2	based on the previous passage_score_eval
anli_based_on_the_previous_passage_r3	anli	r3	based on the previous passage
anli_based_on_the_previous_passage_r3_score_eval	anli	r3	based on the previous passage_score_eval
anli_can_we_infer_r1	anli	r1	can we infer
anli_can_we_infer_r1_score_eval	anli	r1	can we infer_score_eval
anli_can_we_infer_r2	anli	r2	can we infer
anli_can_we_infer_r2_score_eval	anli	r2	can we infer_score_eval
anli_can_we_infer_r3	anli	r3	can we infer
anli_can_we_infer_r3_score_eval	anli	r3	can we infer_score_eval
anli_claim_true_false_inconclusive_r1	anli	r1	claim true/false/inconclusive
anli_claim_true_false_inconclusive_r1_score_eval	anli	r1	claim true/false/inconclusive_score_eval
anli_claim_true_false_inconclusive_r2	anli	r2	claim true/false/inconclusive
anli_claim_true_false_inconclusive_r2_score_eval	anli	r2	claim true/false/inconclusive_score_eval
anli_claim_true_false_inconclusive_r3	anli	r3	claim true/false/inconclusive
anli_claim_true_false_inconclusive_r3_score_eval	anli	r3	claim true/false/inconclusive_score_eval
anli_consider_always_sometimes_never_r1	anli	r1	consider always/sometimes/never
anli_consider_always_sometimes_never_r1_score_eval	anli	r1	consider always/sometimes/never_score_eval
anli_consider_always_sometimes_never_r2	anli	r2	consider always/sometimes/never
anli_consider_always_sometimes_never_r2_score_eval	anli	r2	consider always/sometimes/never_score_eval
anli_consider_always_sometimes_never_r3	anli	r3	consider always/sometimes/never
anli_consider_always_sometimes_never_r3_score_eval	anli	r3	consider always/sometimes/never_score_eval
anli_does_it_follow_that_r1	anli	r1	does it follow that
anli_does_it_follow_that_r1_score_eval	anli	r1	does it follow that_score_eval
anli_does_it_follow_that_r2	anli	r2	does it follow that
anli_does_it_follow_that_r2_score_eval	anli	r2	does it follow that_score_eval
anli_does_it_follow_that_r3	anli	r3	does it follow that
anli_does_it_follow_that_r3_score_eval	anli	r3	does it follow that_score_eval
anli_does_this_imply_r1	anli	r1	does this imply
anli_does_this_imply_r1_score_eval	anli	r1	does this imply_score_eval
anli_does_this_imply_r2	anli	r2	does this imply
anli_does_this_imply_r2_score_eval	anli	r2	does this imply_score_eval
anli_does_this_imply_r3	anli	r3	does this imply
anli_does_this_imply_r3_score_eval	anli	r3	does this imply_score_eval
anli_guaranteed_possible_impossible_r1	anli	r1	guaranteed/possible/impossible
anli_guaranteed_possible_impossible_r1_score_eval	anli	r1	guaranteed/possible/impossible_score_eval
anli_guaranteed_possible_impossible_r2	anli	r2	guaranteed/possible/impossible
anli_guaranteed_possible_impossible_r2_score_eval	anli	r2	guaranteed/possible/impossible_score_eval
anli_guaranteed_possible_impossible_r3	anli	r3	guaranteed/possible/impossible
anli_guaranteed_possible_impossible_r3_score_eval	anli	r3	guaranteed/possible/impossible_score_eval
anli_guaranteed_true_r1	anli	r1	guaranteed true
anli_guaranteed_true_r1_score_eval	anli	r1	guaranteed true_score_eval
anli_guaranteed_true_r2	anli	r2	guaranteed true
anli_guaranteed_true_r2_score_eval	anli	r2	guaranteed true_score_eval
anli_guaranteed_true_r3	anli	r3	guaranteed true
anli_guaranteed_true_r3_score_eval	anli	r3	guaranteed true_score_eval
anli_justified_in_saying_r1	anli	r1	justified in saying
anli_justified_in_saying_r1_score_eval	anli	r1	justified in saying_score_eval
anli_justified_in_saying_r2	anli	r2	justified in saying
anli_justified_in_saying_r2_score_eval	anli	r2	justified in saying_score_eval
anli_justified_in_saying_r3	anli	r3	justified in saying
anli_justified_in_saying_r3_score_eval	anli	r3	justified in saying_score_eval
anli_must_be_true_r1	anli	r1	must be true
anli_must_be_true_r1_score_eval	anli	r1	must be true_score_eval
anli_must_be_true_r2	anli	r2	must be true
anli_must_be_true_r2_score_eval	anli	r2	must be true_score_eval
anli_must_be_true_r3	anli	r3	must be true
anli_must_be_true_r3_score_eval	anli	r3	must be true_score_eval
anli_should_assume_r1	anli	r1	should assume
anli_should_assume_r1_score_eval	anli	r1	should assume_score_eval
anli_should_assume_r2	anli	r2	should assume
anli_should_assume_r2_score_eval	anli	r2	should assume_score_eval
anli_should_assume_r3	anli	r3	should assume
anli_should_assume_r3_score_eval	anli	r3	should assume_score_eval
anli_take_the_following_as_truth_r1	anli	r1	take the following as truth
anli_take_the_following_as_truth_r1_score_eval	anli	r1	take the following as truth_score_eval
anli_take_the_following_as_truth_r2	anli	r2	take the following as truth
anli_take_the_following_as_truth_r2_score_eval	anli	r2	take the following as truth_score_eval
anli_take_the_following_as_truth_r3	anli	r3	take the following as truth
anli_take_the_following_as_truth_r3_score_eval	anli	r3	take the following as truth_score_eval
app_reviews_categorize_rating_using_review	app_reviews		categorize_rating_using_review
app_reviews_categorize_rating_using_review_score_eval	app_reviews		categorize_rating_using_review_score_eval
app_reviews_convert_to_rating	app_reviews		convert_to_rating
app_reviews_convert_to_rating_score_eval	app_reviews		convert_to_rating_score_eval
app_reviews_convert_to_star_rating	app_reviews		convert_to_star_rating
app_reviews_convert_to_star_rating_score_eval	app_reviews		convert_to_star_rating_score_eval
app_reviews_generate_review	app_reviews		generate_review
app_reviews_generate_review_score_eval	app_reviews		generate_review_score_eval
circa_goldstandard1_judgement	circa		goldstandard1_judgement
circa_goldstandard1_judgement_score_eval	circa		goldstandard1_judgement_score_eval
circa_goldstandard2_judgement	circa		goldstandard2_judgement
circa_goldstandard2_judgement_score_eval	circa		goldstandard2_judgement_score_eval
circa_judgement	circa		judgement
circa_judgement_score_eval	circa		judgement_score_eval
circa_possible_qn	circa		possible_qn
circa_possible_qn_score_eval	circa		possible_qn_score_eval
circa_question_declarative	circa		question_declarative
circa_question_declarative_score_eval	circa		question_declarative_score_eval
cnn_dailymail_3.0.0_2_or_3_sentences	cnn_dailymail	3.0.0	2_or_3_sentences
cnn_dailymail_3.0.0_2_or_3_sentences_score_eval	cnn_dailymail	3.0.0	2_or_3_sentences_score_eval
cnn_dailymail_3.0.0_generate_story	cnn_dailymail	3.0.0	generate_story
cnn_dailymail_3.0.0_generate_story_score_eval	cnn_dailymail	3.0.0	generate_story_score_eval
cnn_dailymail_3.0.0_news_card_view	cnn_dailymail	3.0.0	news_card_view
cnn_dailymail_3.0.0_news_card_view_score_eval	cnn_dailymail	3.0.0	news_card_view_score_eval
cnn_dailymail_3.0.0_news_stock	cnn_dailymail	3.0.0	news_stock
cnn_dailymail_3.0.0_news_stock_score_eval	cnn_dailymail	3.0.0	news_stock_score_eval
cnn_dailymail_3.0.0_news_summary	cnn_dailymail	3.0.0	news_summary
cnn_dailymail_3.0.0_news_summary_score_eval	cnn_dailymail	3.0.0	news_summary_score_eval
cnn_dailymail_3.0.0_spice_up_story	cnn_dailymail	3.0.0	spice_up_story
cnn_dailymail_3.0.0_spice_up_story_score_eval	cnn_dailymail	3.0.0	spice_up_story_score_eval
cnn_dailymail_3.0.0_sum_in_brief	cnn_dailymail	3.0.0	sum_in_brief
cnn_dailymail_3.0.0_sum_in_brief_score_eval	cnn_dailymail	3.0.0	sum_in_brief_score_eval
cnn_dailymail_3.0.0_tldr_summary	cnn_dailymail	3.0.0	tldr_summary
cnn_dailymail_3.0.0_tldr_summary_score_eval	cnn_dailymail	3.0.0	tldr_summary_score_eval
cnn_dailymail_3.0.0_write_an_outline	cnn_dailymail	3.0.0	write_an_outline
cnn_dailymail_3.0.0_write_an_outline_score_eval	cnn_dailymail	3.0.0	write_an_outline_score_eval
common_gen_Example_prompt	common_gen		Example prompt
common_gen_Example_prompt_score_eval	common_gen		Example prompt_score_eval
common_gen_Given_concepts_type_1	common_gen		Given concepts type 1
common_gen_Given_concepts_type_1_score_eval	common_gen		Given concepts type 1_score_eval
common_gen_Given_concepts_type_2	common_gen		Given concepts - type 2
common_gen_Given_concepts_type_2_score_eval	common_gen		Given concepts - type 2_score_eval
common_gen_Put_together	common_gen		Put together
common_gen_Put_together_score_eval	common_gen		Put together_score_eval
common_gen_choice_in_concept_centric_sentence_generation	common_gen		choice in concept centric sentence generation
common_gen_choice_in_concept_centric_sentence_generation_score_eval	common_gen		choice in concept centric sentence generation_score_eval
common_gen_random_task_template_prompt	common_gen		random task template prompt
common_gen_random_task_template_prompt_score_eval	common_gen		random task template prompt_score_eval
common_gen_sentence_to_concepts	common_gen		sentence to concepts
common_gen_sentence_to_concepts_score_eval	common_gen		sentence to concepts_score_eval
common_gen_topic_to_sentence	common_gen		topic to sentence
common_gen_topic_to_sentence_score_eval	common_gen		topic to sentence_score_eval
common_gen_topics_from_the_sentence	common_gen		topics from the sentence
common_gen_topics_from_the_sentence_score_eval	common_gen		topics from the sentence_score_eval
coqa_extract_answer_first_qa_turn	coqa		extract_answer_first_qa_turn
coqa_extract_answer_first_qa_turn_score_eval	coqa		extract_answer_first_qa_turn_score_eval
coqa_first_qa_turn	coqa		first_qa_turn
coqa_first_qa_turn_score_eval	coqa		first_qa_turn_score_eval
coqa_generate_dialogue	coqa		generate_dialogue
coqa_generate_dialogue_score_eval	coqa		generate_dialogue_score_eval
coqa_last_qa_turn	coqa		last_qa_turn
coqa_last_qa_turn_score_eval	coqa		last_qa_turn_score_eval
coqa_missing_answer	coqa		missing_answer
coqa_missing_answer_score_eval	coqa		missing_answer_score_eval
cos_e_v1.11_aligned_with_common_sense	cos_e	v1.11	aligned_with_common_sense
cos_e_v1.11_aligned_with_common_sense_score_eval	cos_e	v1.11	aligned_with_common_sense_score_eval
cos_e_v1.11_description_question_option_id	cos_e	v1.11	description_question_option_id
cos_e_v1.11_description_question_option_id_score_eval	cos_e	v1.11	description_question_option_id_score_eval
cos_e_v1.11_description_question_option_text	cos_e	v1.11	description_question_option_text
cos_e_v1.11_description_question_option_text_score_eval	cos_e	v1.11	description_question_option_text_score_eval
cos_e_v1.11_explain_why_human	cos_e	v1.11	explain_why_human
cos_e_v1.11_explain_why_human_score_eval	cos_e	v1.11	explain_why_human_score_eval
cos_e_v1.11_generate_explanation_given_text	cos_e	v1.11	generate_explanation_given_text
cos_e_v1.11_generate_explanation_given_text_score_eval	cos_e	v1.11	generate_explanation_given_text_score_eval
cos_e_v1.11_i_think	cos_e	v1.11	i_think
cos_e_v1.11_i_think_score_eval	cos_e	v1.11	i_think_score_eval
cos_e_v1.11_question_description_option_id	cos_e	v1.11	question_description_option_id
cos_e_v1.11_question_description_option_id_score_eval	cos_e	v1.11	question_description_option_id_score_eval
cos_e_v1.11_question_description_option_text	cos_e	v1.11	question_description_option_text
cos_e_v1.11_question_description_option_text_score_eval	cos_e	v1.11	question_description_option_text_score_eval
cos_e_v1.11_question_option_description_id	cos_e	v1.11	question_option_description_id
cos_e_v1.11_question_option_description_id_score_eval	cos_e	v1.11	question_option_description_id_score_eval
cos_e_v1.11_question_option_description_text	cos_e	v1.11	question_option_description_text
cos_e_v1.11_question_option_description_text_score_eval	cos_e	v1.11	question_option_description_text_score_eval
cos_e_v1.11_rationale	cos_e	v1.11	rationale
cos_e_v1.11_rationale_score_eval	cos_e	v1.11	rationale_score_eval
cosmos_qa_context_answer_to_question	cosmos_qa		context_answer_to_question
cosmos_qa_context_answer_to_question_score_eval	cosmos_qa		context_answer_to_question_score_eval
cosmos_qa_context_description_question_answer_id	cosmos_qa		context_description_question_answer_id
cosmos_qa_context_description_question_answer_id_score_eval	cosmos_qa		context_description_question_answer_id_score_eval
cosmos_qa_context_description_question_answer_text	cosmos_qa		context_description_question_answer_text
cosmos_qa_context_description_question_answer_text_score_eval	cosmos_qa		context_description_question_answer_text_score_eval
cosmos_qa_context_description_question_text	cosmos_qa		context_description_question_text
cosmos_qa_context_description_question_text_score_eval	cosmos_qa		context_description_question_text_score_eval
cosmos_qa_context_question_description_answer_id	cosmos_qa		context_question_description_answer_id
cosmos_qa_context_question_description_answer_id_score_eval	cosmos_qa		context_question_description_answer_id_score_eval
cosmos_qa_context_question_description_answer_text	cosmos_qa		context_question_description_answer_text
cosmos_qa_context_question_description_answer_text_score_eval	cosmos_qa		context_question_description_answer_text_score_eval
cosmos_qa_context_question_description_text	cosmos_qa		context_question_description_text
cosmos_qa_context_question_description_text_score_eval	cosmos_qa		context_question_description_text_score_eval
cosmos_qa_description_context_question_answer_id	cosmos_qa		description_context_question_answer_id
cosmos_qa_description_context_question_answer_id_score_eval	cosmos_qa		description_context_question_answer_id_score_eval
cosmos_qa_description_context_question_answer_text	cosmos_qa		description_context_question_answer_text
cosmos_qa_description_context_question_answer_text_score_eval	cosmos_qa		description_context_question_answer_text_score_eval
cosmos_qa_description_context_question_text	cosmos_qa		description_context_question_text
cosmos_qa_description_context_question_text_score_eval	cosmos_qa		description_context_question_text_score_eval
cosmos_qa_no_prompt_id	cosmos_qa		no_prompt_id
cosmos_qa_no_prompt_id_score_eval	cosmos_qa		no_prompt_id_score_eval
cosmos_qa_no_prompt_text	cosmos_qa		no_prompt_text
cosmos_qa_no_prompt_text_score_eval	cosmos_qa		no_prompt_text_score_eval
cosmos_qa_only_question_answer	cosmos_qa		only_question_answer
cosmos_qa_only_question_answer_score_eval	cosmos_qa		only_question_answer_score_eval
craffel_openai_lambada_GPT_3_style	craffel/openai_lambada		GPT-3 style
craffel_openai_lambada_GPT_3_style_score_eval	craffel/openai_lambada		GPT-3 style_score_eval
craffel_openai_lambada_ellipses	craffel/openai_lambada		ellipses
craffel_openai_lambada_ellipses_score_eval	craffel/openai_lambada		ellipses_score_eval
craffel_openai_lambada_fill_in_the_____	craffel/openai_lambada		fill in the ____
craffel_openai_lambada_fill_in_the______score_eval	craffel/openai_lambada		fill in the _____score_eval
craffel_openai_lambada_please_next_word	craffel/openai_lambada		please next word
craffel_openai_lambada_please_next_word_score_eval	craffel/openai_lambada		please next word_score_eval
craffel_openai_lambada_what_comes_next	craffel/openai_lambada		what comes next
craffel_openai_lambada_what_comes_next_score_eval	craffel/openai_lambada		what comes next_score_eval
crows_pairs_anti_stereotype	crows_pairs		anti_stereotype
crows_pairs_anti_stereotype_confirm	crows_pairs		anti_stereotype_confirm
crows_pairs_anti_stereotype_confirm_score_eval	crows_pairs		anti_stereotype_confirm_score_eval
crows_pairs_anti_stereotype_score_eval	crows_pairs		anti_stereotype_score_eval
crows_pairs_demontraste_or_violate	crows_pairs		demontraste_or_violate
crows_pairs_demontraste_or_violate_score_eval	crows_pairs		demontraste_or_violate_score_eval
crows_pairs_stereotype	crows_pairs		stereotype
crows_pairs_stereotype_confirm	crows_pairs		stereotype_confirm
crows_pairs_stereotype_confirm_score_eval	crows_pairs		stereotype_confirm_score_eval
crows_pairs_stereotype_score_eval	crows_pairs		stereotype_score_eval
crows_pairs_transform_anti_stereo	crows_pairs		transform_anti_stereo
crows_pairs_transform_anti_stereo_score_eval	crows_pairs		transform_anti_stereo_score_eval
crows_pairs_transform_stereo	crows_pairs		transform_stereo
crows_pairs_transform_stereo_score_eval	crows_pairs		transform_stereo_score_eval
crows_pairs_which_bias	crows_pairs		which_bias
crows_pairs_which_bias_score_eval	crows_pairs		which_bias_score_eval
dbpedia_14_given_a_choice_of_categories_	dbpedia_14		given_a_choice_of_categories 
dbpedia_14_given_a_choice_of_categories__score_eval	dbpedia_14		given_a_choice_of_categories _score_eval
dbpedia_14_given_a_list_of_category_what_does_the_title_belong_to	dbpedia_14		given_a_list_of_category_what_does_the_title_belong_to
dbpedia_14_given_a_list_of_category_what_does_the_title_belong_to_score_eval	dbpedia_14		given_a_list_of_category_what_does_the_title_belong_to_score_eval
dbpedia_14_given_list_what_category_does_the_paragraph_belong_to	dbpedia_14		given_list_what_category_does_the_paragraph_belong_to
dbpedia_14_given_list_what_category_does_the_paragraph_belong_to_score_eval	dbpedia_14		given_list_what_category_does_the_paragraph_belong_to_score_eval
dbpedia_14_pick_one_category_for_the_following_text	dbpedia_14		pick_one_category_for_the_following_text
dbpedia_14_pick_one_category_for_the_following_text_score_eval	dbpedia_14		pick_one_category_for_the_following_text_score_eval
dream_answer_to_dialogue	dream		answer-to-dialogue
dream_answer_to_dialogue_score_eval	dream		answer-to-dialogue_score_eval
dream_baseline	dream		baseline
dream_baseline_score_eval	dream		baseline_score_eval
dream_generate_first_utterance	dream		generate-first-utterance
dream_generate_first_utterance_score_eval	dream		generate-first-utterance_score_eval
dream_generate_last_utterance	dream		generate-last-utterance
dream_generate_last_utterance_score_eval	dream		generate-last-utterance_score_eval
dream_read_the_following_conversation_and_answer_the_question	dream		read_the_following_conversation_and_answer_the_question
dream_read_the_following_conversation_and_answer_the_question_score_eval	dream		read_the_following_conversation_and_answer_the_question_score_eval
drop_DROP_GPT3	drop		DROP GPT3
drop_DROP_GPT3_score_eval	drop		DROP GPT3_score_eval
drop_can_you_tell_me	drop		can you tell me
drop_can_you_tell_me_score_eval	drop		can you tell me_score_eval
drop_context_question_answer	drop		context question answer
drop_context_question_answer_score_eval	drop		context question answer_score_eval
drop_generate_question_with_passage_and_answer	drop		generate_question_with_passage_and_answer
drop_generate_question_with_passage_and_answer_score_eval	drop		generate_question_with_passage_and_answer_score_eval
drop_question_context_answer	drop		question context answer
drop_question_context_answer_score_eval	drop		question context answer_score_eval
duorc_ParaphraseRC_answer_question	duorc	ParaphraseRC	answer_question
duorc_ParaphraseRC_answer_question_score_eval	duorc	ParaphraseRC	answer_question_score_eval
duorc_ParaphraseRC_build_story_around_qa	duorc	ParaphraseRC	build_story_around_qa
duorc_ParaphraseRC_build_story_around_qa_score_eval	duorc	ParaphraseRC	build_story_around_qa_score_eval
duorc_ParaphraseRC_decide_worth_it	duorc	ParaphraseRC	decide_worth_it
duorc_ParaphraseRC_decide_worth_it_score_eval	duorc	ParaphraseRC	decide_worth_it_score_eval
duorc_ParaphraseRC_extract_answer	duorc	ParaphraseRC	extract_answer
duorc_ParaphraseRC_extract_answer_score_eval	duorc	ParaphraseRC	extract_answer_score_eval
duorc_ParaphraseRC_generate_question	duorc	ParaphraseRC	generate_question
duorc_ParaphraseRC_generate_question_by_answer	duorc	ParaphraseRC	generate_question_by_answer
duorc_ParaphraseRC_generate_question_by_answer_score_eval	duorc	ParaphraseRC	generate_question_by_answer_score_eval
duorc_ParaphraseRC_generate_question_score_eval	duorc	ParaphraseRC	generate_question_score_eval
duorc_ParaphraseRC_movie_director	duorc	ParaphraseRC	movie_director
duorc_ParaphraseRC_movie_director_score_eval	duorc	ParaphraseRC	movie_director_score_eval
duorc_ParaphraseRC_question_answering	duorc	ParaphraseRC	question_answering
duorc_ParaphraseRC_question_answering_score_eval	duorc	ParaphraseRC	question_answering_score_eval
duorc_ParaphraseRC_title_generation	duorc	ParaphraseRC	title_generation
duorc_ParaphraseRC_title_generation_score_eval	duorc	ParaphraseRC	title_generation_score_eval
duorc_SelfRC_answer_question	duorc	SelfRC	answer_question
duorc_SelfRC_answer_question_score_eval	duorc	SelfRC	answer_question_score_eval
duorc_SelfRC_build_story_around_qa	duorc	SelfRC	build_story_around_qa
duorc_SelfRC_build_story_around_qa_score_eval	duorc	SelfRC	build_story_around_qa_score_eval
duorc_SelfRC_decide_worth_it	duorc	SelfRC	decide_worth_it
duorc_SelfRC_decide_worth_it_score_eval	duorc	SelfRC	decide_worth_it_score_eval
duorc_SelfRC_extract_answer	duorc	SelfRC	extract_answer
duorc_SelfRC_extract_answer_score_eval	duorc	SelfRC	extract_answer_score_eval
duorc_SelfRC_generate_question	duorc	SelfRC	generate_question
duorc_SelfRC_generate_question_by_answer	duorc	SelfRC	generate_question_by_answer
duorc_SelfRC_generate_question_by_answer_score_eval	duorc	SelfRC	generate_question_by_answer_score_eval
duorc_SelfRC_generate_question_score_eval	duorc	SelfRC	generate_question_score_eval
duorc_SelfRC_movie_director	duorc	SelfRC	movie_director
duorc_SelfRC_movie_director_score_eval	duorc	SelfRC	movie_director_score_eval
duorc_SelfRC_question_answering	duorc	SelfRC	question_answering
duorc_SelfRC_question_answering_score_eval	duorc	SelfRC	question_answering_score_eval
duorc_SelfRC_title_generation	duorc	SelfRC	title_generation
duorc_SelfRC_title_generation_score_eval	duorc	SelfRC	title_generation_score_eval
gigaword_TLDR	gigaword		TLDR
gigaword_TLDR_score_eval	gigaword		TLDR_score_eval
gigaword_first_sentence_title	gigaword		first_sentence_title
gigaword_first_sentence_title_score_eval	gigaword		first_sentence_title_score_eval
gigaword_generate_summary_for_this	gigaword		generate_summary_for_this
gigaword_generate_summary_for_this_score_eval	gigaword		generate_summary_for_this_score_eval
gigaword_in_a_nutshell	gigaword		in_a_nutshell
gigaword_in_a_nutshell_score_eval	gigaword		in_a_nutshell_score_eval
gigaword_make_a_title	gigaword		make_a_title
gigaword_make_a_title_score_eval	gigaword		make_a_title_score_eval
gigaword_reverse_writing	gigaword		reverse_writing
gigaword_reverse_writing_score_eval	gigaword		reverse_writing_score_eval
gigaword_write_a_title_for_this_sentence	gigaword		write_a_title_for_this_sentence
gigaword_write_a_title_for_this_sentence_score_eval	gigaword		write_a_title_for_this_sentence_score_eval
gigaword_write_an_article	gigaword		write_an_article
gigaword_write_an_article_score_eval	gigaword		write_an_article_score_eval
gigaword_write_its_sentence	gigaword		write_its_sentence
gigaword_write_its_sentence_score_eval	gigaword		write_its_sentence_score_eval
glue_cola_Following_sentence_acceptable	glue	cola	Following sentence acceptable
glue_cola_Following_sentence_acceptable_score_eval	glue	cola	Following sentence acceptable_score_eval
glue_cola_Make_sense_yes_no	glue	cola	Make sense yes no
glue_cola_Make_sense_yes_no_score_eval	glue	cola	Make sense yes no_score_eval
glue_cola_Previous_sentence_acceptable	glue	cola	Previous sentence acceptable
glue_cola_Previous_sentence_acceptable_score_eval	glue	cola	Previous sentence acceptable_score_eval
glue_cola_editing	glue	cola	editing
glue_cola_editing_score_eval	glue	cola	editing_score_eval
glue_cola_is_this_correct	glue	cola	is_this_correct
glue_cola_is_this_correct_score_eval	glue	cola	is_this_correct_score_eval
glue_mrpc_equivalent	glue	mrpc	equivalent
glue_mrpc_equivalent_score_eval	glue	mrpc	equivalent_score_eval
glue_mrpc_generate_paraphrase	glue	mrpc	generate_paraphrase
glue_mrpc_generate_paraphrase_score_eval	glue	mrpc	generate_paraphrase_score_eval
glue_mrpc_generate_sentence	glue	mrpc	generate_sentence
glue_mrpc_generate_sentence_score_eval	glue	mrpc	generate_sentence_score_eval
glue_mrpc_paraphrase	glue	mrpc	paraphrase
glue_mrpc_paraphrase_score_eval	glue	mrpc	paraphrase_score_eval
glue_mrpc_replace	glue	mrpc	replace
glue_mrpc_replace_score_eval	glue	mrpc	replace_score_eval
glue_mrpc_same_thing	glue	mrpc	same thing
glue_mrpc_same_thing_score_eval	glue	mrpc	same thing_score_eval
glue_mrpc_want_to_know	glue	mrpc	want to know
glue_mrpc_want_to_know_score_eval	glue	mrpc	want to know_score_eval
glue_qqp_answer	glue	qqp	answer
glue_qqp_answer_score_eval	glue	qqp	answer_score_eval
glue_qqp_duplicate	glue	qqp	duplicate
glue_qqp_duplicate_or_not	glue	qqp	duplicate or not
glue_qqp_duplicate_or_not_score_eval	glue	qqp	duplicate or not_score_eval
glue_qqp_duplicate_score_eval	glue	qqp	duplicate_score_eval
glue_qqp_meaning	glue	qqp	meaning
glue_qqp_meaning_score_eval	glue	qqp	meaning_score_eval
glue_qqp_quora	glue	qqp	quora
glue_qqp_quora_score_eval	glue	qqp	quora_score_eval
glue_qqp_same_thing	glue	qqp	same thing
glue_qqp_same_thing_score_eval	glue	qqp	same thing_score_eval
hans_GPT_3_style	hans		GPT-3 style
hans_GPT_3_style_score_eval	hans		GPT-3 style_score_eval
hans_MNLI_crowdsource	hans		MNLI crowdsource
hans_MNLI_crowdsource_score_eval	hans		MNLI crowdsource_score_eval
hans_based_on_the_previous_passage	hans		based on the previous passage
hans_based_on_the_previous_passage_score_eval	hans		based on the previous passage_score_eval
hans_can_we_infer	hans		can we infer
hans_can_we_infer_score_eval	hans		can we infer_score_eval
hans_does_it_follow_that	hans		does it follow that
hans_does_it_follow_that_score_eval	hans		does it follow that_score_eval
hans_does_this_imply	hans		does this imply
hans_does_this_imply_score_eval	hans		does this imply_score_eval
hans_guaranteed_true	hans		guaranteed true
hans_guaranteed_true_score_eval	hans		guaranteed true_score_eval
hans_justified_in_saying	hans		justified in saying
hans_justified_in_saying_score_eval	hans		justified in saying_score_eval
hans_must_be_true	hans		must be true
hans_must_be_true_score_eval	hans		must be true_score_eval
hans_should_assume	hans		should assume
hans_should_assume_score_eval	hans		should assume_score_eval
hellaswag_Appropriate_continuation_Yes_or_No	hellaswag		Appropriate continuation - Yes or No
hellaswag_Appropriate_continuation_Yes_or_No_score_eval	hellaswag		Appropriate continuation - Yes or No_score_eval
hellaswag_Open_ended_completion	hellaswag		Open-ended completion
hellaswag_Open_ended_completion_score_eval	hellaswag		Open-ended completion_score_eval
hellaswag_Open_ended_start	hellaswag		Open-ended start
hellaswag_Open_ended_start_score_eval	hellaswag		Open-ended start_score_eval
hellaswag_Predict_ending_with_hint	hellaswag		Predict ending with hint
hellaswag_Predict_ending_with_hint_score_eval	hellaswag		Predict ending with hint_score_eval
hellaswag_Randomized_prompts_template	hellaswag		Randomized prompts template
hellaswag_Randomized_prompts_template_score_eval	hellaswag		Randomized prompts template_score_eval
hellaswag_Reversed_appropriate_continuation_Yes_or_No	hellaswag		Reversed appropriate continuation - Yes or No
hellaswag_Reversed_appropriate_continuation_Yes_or_No_score_eval	hellaswag		Reversed appropriate continuation - Yes or No_score_eval
hellaswag_Topic_of_the_context	hellaswag		Topic of the context
hellaswag_Topic_of_the_context_score_eval	hellaswag		Topic of the context_score_eval
hellaswag_Topic_without_the_ending_answer	hellaswag		Topic without the ending answer
hellaswag_Topic_without_the_ending_answer_score_eval	hellaswag		Topic without the ending answer_score_eval
hellaswag_complete_first_then	hellaswag		complete_first_then
hellaswag_complete_first_then_score_eval	hellaswag		complete_first_then_score_eval
hellaswag_how_ends	hellaswag		how_ends
hellaswag_how_ends_score_eval	hellaswag		how_ends_score_eval
hellaswag_if_begins_how_continues	hellaswag		if_begins_how_continues
hellaswag_if_begins_how_continues_score_eval	hellaswag		if_begins_how_continues_score_eval
imdb_Movie_Expressed_Sentiment	imdb		Movie Expressed Sentiment
imdb_Movie_Expressed_Sentiment_2	imdb		Movie Expressed Sentiment 2
imdb_Movie_Expressed_Sentiment_2_score_eval	imdb		Movie Expressed Sentiment 2_score_eval
imdb_Movie_Expressed_Sentiment_score_eval	imdb		Movie Expressed Sentiment_score_eval
imdb_Negation_template_for_positive_and_negative	imdb		Negation template for positive and negative
imdb_Negation_template_for_positive_and_negative_score_eval	imdb		Negation template for positive and negative_score_eval
imdb_Reviewer_Enjoyment	imdb		Reviewer Enjoyment
imdb_Reviewer_Enjoyment_Yes_No	imdb		Reviewer Enjoyment Yes No
imdb_Reviewer_Enjoyment_Yes_No_score_eval	imdb		Reviewer Enjoyment Yes No_score_eval
imdb_Reviewer_Enjoyment_score_eval	imdb		Reviewer Enjoyment_score_eval
imdb_Reviewer_Expressed_Sentiment	imdb		Reviewer Expressed Sentiment
imdb_Reviewer_Expressed_Sentiment_score_eval	imdb		Reviewer Expressed Sentiment_score_eval
imdb_Reviewer_Opinion_bad_good_choices	imdb		Reviewer Opinion bad good choices
imdb_Reviewer_Opinion_bad_good_choices_score_eval	imdb		Reviewer Opinion bad good choices_score_eval
imdb_Reviewer_Sentiment_Feeling	imdb		Reviewer Sentiment Feeling
imdb_Reviewer_Sentiment_Feeling_score_eval	imdb		Reviewer Sentiment Feeling_score_eval
imdb_Sentiment_with_choices_	imdb		Sentiment with choices 
imdb_Sentiment_with_choices__score_eval	imdb		Sentiment with choices _score_eval
imdb_Text_Expressed_Sentiment	imdb		Text Expressed Sentiment
imdb_Text_Expressed_Sentiment_score_eval	imdb		Text Expressed Sentiment_score_eval
imdb_Writer_Expressed_Sentiment	imdb		Writer Expressed Sentiment
imdb_Writer_Expressed_Sentiment_score_eval	imdb		Writer Expressed Sentiment_score_eval
kilt_tasks_hotpotqa_combining_facts	kilt_tasks	hotpotqa	combining_facts
kilt_tasks_hotpotqa_combining_facts_score_eval	kilt_tasks	hotpotqa	combining_facts_score_eval
kilt_tasks_hotpotqa_complex_question	kilt_tasks	hotpotqa	complex_question
kilt_tasks_hotpotqa_complex_question_score_eval	kilt_tasks	hotpotqa	complex_question_score_eval
kilt_tasks_hotpotqa_final_exam	kilt_tasks	hotpotqa	final_exam
kilt_tasks_hotpotqa_final_exam_score_eval	kilt_tasks	hotpotqa	final_exam_score_eval
kilt_tasks_hotpotqa_formulate	kilt_tasks	hotpotqa	formulate
kilt_tasks_hotpotqa_formulate_score_eval	kilt_tasks	hotpotqa	formulate_score_eval
kilt_tasks_hotpotqa_straighforward_qa	kilt_tasks	hotpotqa	straighforward_qa
kilt_tasks_hotpotqa_straighforward_qa_score_eval	kilt_tasks	hotpotqa	straighforward_qa_score_eval
lambada_GPT_3_style	lambada		GPT-3 style
lambada_GPT_3_style_score_eval	lambada		GPT-3 style_score_eval
lambada_ellipses	lambada		ellipses
lambada_ellipses_score_eval	lambada		ellipses_score_eval
lambada_fill_in_the_____	lambada		fill in the ____
lambada_fill_in_the______score_eval	lambada		fill in the _____score_eval
lambada_please_next_word	lambada		please next word
lambada_please_next_word_score_eval	lambada		please next word_score_eval
lambada_what_comes_next	lambada		what comes next
lambada_what_comes_next_score_eval	lambada		what comes next_score_eval
mc_taco_asked_my_friend	mc_taco		asked_my_friend
mc_taco_asked_my_friend_doubt	mc_taco		asked_my_friend_doubt
mc_taco_asked_my_friend_doubt_score_eval	mc_taco		asked_my_friend_doubt_score_eval
mc_taco_asked_my_friend_score_eval	mc_taco		asked_my_friend_score_eval
mc_taco_believable	mc_taco		believable
mc_taco_believable_score_eval	mc_taco		believable_score_eval
mc_taco_formal_description	mc_taco		formal_description
mc_taco_formal_description_score_eval	mc_taco		formal_description_score_eval
mc_taco_generate_answer_from_question_and_context	mc_taco		generate_answer_from_question_and_context
mc_taco_generate_answer_from_question_and_context_score_eval	mc_taco		generate_answer_from_question_and_context_score_eval
mc_taco_observe_check_plausible_yes_no	mc_taco		observe_check_plausible_yes_no
mc_taco_observe_check_plausible_yes_no_score_eval	mc_taco		observe_check_plausible_yes_no_score_eval
mc_taco_plausible_negated	mc_taco		plausible_negated
mc_taco_plausible_negated_score_eval	mc_taco		plausible_negated_score_eval
mc_taco_plausible_true_false	mc_taco		plausible_true_false
mc_taco_plausible_true_false_score_eval	mc_taco		plausible_true_false_score_eval
mc_taco_temporal_categories_no_choices	mc_taco		temporal_categories_no_choices
mc_taco_temporal_categories_no_choices_score_eval	mc_taco		temporal_categories_no_choices_score_eval
mc_taco_temporal_categories_with_choices	mc_taco		temporal_categories_with_choices
mc_taco_temporal_categories_with_choices_score_eval	mc_taco		temporal_categories_with_choices_score_eval
multi_news_distill	multi_news		distill
multi_news_distill_score_eval	multi_news		distill_score_eval
multi_news_expand_reverse_task_	multi_news		expand (reverse task)
multi_news_expand_reverse_task__score_eval	multi_news		expand (reverse task)_score_eval
multi_news_summarize	multi_news		summarize
multi_news_summarize_score_eval	multi_news		summarize_score_eval
multi_news_summary_scenario	multi_news		summary scenario
multi_news_summary_scenario_score_eval	multi_news		summary scenario_score_eval
multi_news_synthesize	multi_news		synthesize
multi_news_synthesize_score_eval	multi_news		synthesize_score_eval
multi_news_what_are_the_key_points	multi_news		what are the key points
multi_news_what_are_the_key_points_score_eval	multi_news		what are the key points_score_eval
nq_open_first_person_context	nq_open		first_person_context
nq_open_first_person_context_score_eval	nq_open		first_person_context_score_eval
nq_open_formal_description	nq_open		formal_description
nq_open_formal_description_score_eval	nq_open		formal_description_score_eval
nq_open_guess_question	nq_open		guess_question
nq_open_guess_question_score_eval	nq_open		guess_question_score_eval
nq_open_question_answer	nq_open		question_answer
nq_open_question_answer_score_eval	nq_open		question_answer_score_eval
nq_open_question_with_instruction	nq_open		question_with_instruction
nq_open_question_with_instruction_score_eval	nq_open		question_with_instruction_score_eval
nq_open_search_query	nq_open		search query
nq_open_search_query_score_eval	nq_open		search query_score_eval
openbookqa_main_choices	openbookqa	main	choices
openbookqa_main_choices_score_eval	openbookqa	main	choices_score_eval
openbookqa_main_choose_an_answer_with_options	openbookqa	main	choose_an_answer_with_options
openbookqa_main_choose_an_answer_with_options_score_eval	openbookqa	main	choose_an_answer_with_options_score_eval
openbookqa_main_only_options	openbookqa	main	only_options
openbookqa_main_only_options_score_eval	openbookqa	main	only_options_score_eval
openbookqa_main_pick_answer_with_options	openbookqa	main	pick_answer_with_options
openbookqa_main_pick_answer_with_options_score_eval	openbookqa	main	pick_answer_with_options_score_eval
openbookqa_main_pick_using_id	openbookqa	main	pick_using_id
openbookqa_main_pick_using_id_score_eval	openbookqa	main	pick_using_id_score_eval
openbookqa_main_which_correct	openbookqa	main	which_correct
openbookqa_main_which_correct_inverse	openbookqa	main	which_correct_inverse
openbookqa_main_which_correct_inverse_score_eval	openbookqa	main	which_correct_inverse_score_eval
openbookqa_main_which_correct_score_eval	openbookqa	main	which_correct_score_eval
paws_labeled_final_Concatenation	paws	labeled_final	Concatenation
paws_labeled_final_Concatenation_no_label	paws	labeled_final	Concatenation-no-label
paws_labeled_final_Concatenation_no_label_score_eval	paws	labeled_final	Concatenation-no-label_score_eval
paws_labeled_final_Concatenation_score_eval	paws	labeled_final	Concatenation_score_eval
paws_labeled_final_Meaning	paws	labeled_final	Meaning
paws_labeled_final_Meaning_no_label	paws	labeled_final	Meaning-no-label
paws_labeled_final_Meaning_no_label_score_eval	paws	labeled_final	Meaning-no-label_score_eval
paws_labeled_final_Meaning_score_eval	paws	labeled_final	Meaning_score_eval
paws_labeled_final_PAWS_ANLI_GPT3	paws	labeled_final	PAWS-ANLI GPT3
paws_labeled_final_PAWS_ANLI_GPT3_no_label	paws	labeled_final	PAWS-ANLI GPT3-no-label
paws_labeled_final_PAWS_ANLI_GPT3_no_label_score_eval	paws	labeled_final	PAWS-ANLI GPT3-no-label_score_eval
paws_labeled_final_PAWS_ANLI_GPT3_score_eval	paws	labeled_final	PAWS-ANLI GPT3_score_eval
paws_labeled_final_Rewrite	paws	labeled_final	Rewrite
paws_labeled_final_Rewrite_no_label	paws	labeled_final	Rewrite-no-label
paws_labeled_final_Rewrite_no_label_score_eval	paws	labeled_final	Rewrite-no-label_score_eval
paws_labeled_final_Rewrite_score_eval	paws	labeled_final	Rewrite_score_eval
paws_labeled_final_context_question	paws	labeled_final	context-question
paws_labeled_final_context_question_no_label	paws	labeled_final	context-question-no-label
paws_labeled_final_context_question_no_label_score_eval	paws	labeled_final	context-question-no-label_score_eval
paws_labeled_final_context_question_score_eval	paws	labeled_final	context-question_score_eval
paws_labeled_final_paraphrase_task	paws	labeled_final	paraphrase-task
paws_labeled_final_paraphrase_task_score_eval	paws	labeled_final	paraphrase-task_score_eval
paws_labeled_final_task_description_no_label	paws	labeled_final	task_description-no-label
paws_labeled_final_task_description_no_label_score_eval	paws	labeled_final	task_description-no-label_score_eval
piqa_Correct_the_solution	piqa		Correct the solution
piqa_Correct_the_solution_if_false_from_sol_1	piqa		Correct the solution if false: from sol 1
piqa_Correct_the_solution_if_false_from_sol_1_score_eval	piqa		Correct the solution if false: from sol 1_score_eval
piqa_Correct_the_solution_if_false_from_sol_2	piqa		Correct the solution if false: from sol 2
piqa_Correct_the_solution_if_false_from_sol_2_score_eval	piqa		Correct the solution if false: from sol 2_score_eval
piqa_Correct_the_solution_score_eval	piqa		Correct the solution_score_eval
piqa_Does_this_solution_make_sense_sol1	piqa		Does this solution make sense? sol1
piqa_Does_this_solution_make_sense_sol1_score_eval	piqa		Does this solution make sense? sol1_score_eval
piqa_Does_this_solution_make_sense_sol2	piqa		Does this solution make sense? sol2
piqa_Does_this_solution_make_sense_sol2_score_eval	piqa		Does this solution make sense? sol2_score_eval
piqa_choose_the_most_appropriate_solution	piqa		choose the most appropriate solution
piqa_choose_the_most_appropriate_solution_score_eval	piqa		choose the most appropriate solution_score_eval
piqa_finish_sentence_with_correct_choice	piqa		finish_sentence_with_correct_choice
piqa_finish_sentence_with_correct_choice_score_eval	piqa		finish_sentence_with_correct_choice_score_eval
piqa_no_prompt_needed	piqa		no prompt needed
piqa_no_prompt_needed_score_eval	piqa		no prompt needed_score_eval
piqa_pick_correct_choice_index	piqa		pick_correct_choice_index
piqa_pick_correct_choice_index_score_eval	piqa		pick_correct_choice_index_score_eval
piqa_pick_correct_choice_with_choice_given_before_goal	piqa		pick_correct_choice_with_choice_given_before_goal
piqa_pick_correct_choice_with_choice_given_before_goal_score_eval	piqa		pick_correct_choice_with_choice_given_before_goal_score_eval
piqa_what_is_the_correct_ending	piqa		what_is_the_correct_ending
piqa_what_is_the_correct_ending_score_eval	piqa		what_is_the_correct_ending_score_eval
qa_srl_answer_question	qa_srl		answer_question
qa_srl_answer_question_score_eval	qa_srl		answer_question_score_eval
qa_srl_deconstruct_sentence	qa_srl		deconstruct_sentence
qa_srl_deconstruct_sentence_score_eval	qa_srl		deconstruct_sentence_score_eval
qa_srl_generate_question	qa_srl		generate_question
qa_srl_generate_question_score_eval	qa_srl		generate_question_score_eval
qa_srl_identify_predicate	qa_srl		identify_predicate
qa_srl_identify_predicate_score_eval	qa_srl		identify_predicate_score_eval
qa_srl_linguistic_problem	qa_srl		linguistic_problem
qa_srl_linguistic_problem_score_eval	qa_srl		linguistic_problem_score_eval
qa_srl_parse_structure	qa_srl		parse_structure
qa_srl_parse_structure_score_eval	qa_srl		parse_structure_score_eval
qa_srl_sentence_question_concatenation	qa_srl		sentence_question_concatenation
qa_srl_sentence_question_concatenation_score_eval	qa_srl		sentence_question_concatenation_score_eval
qasc_is_correct_1	qasc		is_correct_1
qasc_is_correct_1_score_eval	qasc		is_correct_1_score_eval
qasc_is_correct_2	qasc		is_correct_2
qasc_is_correct_2_score_eval	qasc		is_correct_2_score_eval
qasc_qa_with_combined_facts_1	qasc		qa_with_combined_facts_1
qasc_qa_with_combined_facts_1_score_eval	qasc		qa_with_combined_facts_1_score_eval
qasc_qa_with_separated_facts_1	qasc		qa_with_separated_facts_1
qasc_qa_with_separated_facts_1_score_eval	qasc		qa_with_separated_facts_1_score_eval
qasc_qa_with_separated_facts_2	qasc		qa_with_separated_facts_2
qasc_qa_with_separated_facts_2_score_eval	qasc		qa_with_separated_facts_2_score_eval
qasc_qa_with_separated_facts_3	qasc		qa_with_separated_facts_3
qasc_qa_with_separated_facts_3_score_eval	qasc		qa_with_separated_facts_3_score_eval
qasc_qa_with_separated_facts_4	qasc		qa_with_separated_facts_4
qasc_qa_with_separated_facts_4_score_eval	qasc		qa_with_separated_facts_4_score_eval
qasc_qa_with_separated_facts_5	qasc		qa_with_separated_facts_5
qasc_qa_with_separated_facts_5_score_eval	qasc		qa_with_separated_facts_5_score_eval
quac_Answer_Converation_	quac		Answer Converation 
quac_Answer_Converation__score_eval	quac		Answer Converation _score_eval
quac_Answer_Given_Full_Dialogue	quac		Answer Given Full Dialogue
quac_Answer_Given_Full_Dialogue_score_eval	quac		Answer Given Full Dialogue_score_eval
quac_Answer_Given_Only_First_Dialogue	quac		Answer Given Only First Dialogue
quac_Answer_Given_Only_First_Dialogue_score_eval	quac		Answer Given Only First Dialogue_score_eval
quac_Context_First_	quac		Context First 
quac_Context_First__score_eval	quac		Context First _score_eval
quac_Student_Asking_Teacher_	quac		Student Asking Teacher 
quac_Student_Asking_Teacher__score_eval	quac		Student Asking Teacher _score_eval
quac_Use_Dialogue_as_Hint	quac		Use Dialogue as Hint
quac_Use_Dialogue_as_Hint_score_eval	quac		Use Dialogue as Hint_score_eval
quail_context_description_question_answer_id	quail		context_description_question_answer_id
quail_context_description_question_answer_id_score_eval	quail		context_description_question_answer_id_score_eval
quail_context_description_question_answer_text	quail		context_description_question_answer_text
quail_context_description_question_answer_text_score_eval	quail		context_description_question_answer_text_score_eval
quail_context_description_question_text	quail		context_description_question_text
quail_context_description_question_text_score_eval	quail		context_description_question_text_score_eval
quail_context_question_answer_description_id	quail		context_question_answer_description_id
quail_context_question_answer_description_id_score_eval	quail		context_question_answer_description_id_score_eval
quail_context_question_answer_description_text	quail		context_question_answer_description_text
quail_context_question_answer_description_text_score_eval	quail		context_question_answer_description_text_score_eval
quail_context_question_description_answer_id	quail		context_question_description_answer_id
quail_context_question_description_answer_id_score_eval	quail		context_question_description_answer_id_score_eval
quail_context_question_description_answer_text	quail		context_question_description_answer_text
quail_context_question_description_answer_text_score_eval	quail		context_question_description_answer_text_score_eval
quail_context_question_description_text	quail		context_question_description_text
quail_context_question_description_text_score_eval	quail		context_question_description_text_score_eval
quail_description_context_question_answer_id	quail		description_context_question_answer_id
quail_description_context_question_answer_id_score_eval	quail		description_context_question_answer_id_score_eval
quail_description_context_question_answer_text	quail		description_context_question_answer_text
quail_description_context_question_answer_text_score_eval	quail		description_context_question_answer_text_score_eval
quail_description_context_question_text	quail		description_context_question_text
quail_description_context_question_text_score_eval	quail		description_context_question_text_score_eval
quail_no_prompt_id	quail		no_prompt_id
quail_no_prompt_id_score_eval	quail		no_prompt_id_score_eval
quail_no_prompt_text	quail		no_prompt_text
quail_no_prompt_text_score_eval	quail		no_prompt_text_score_eval
quarel_choose_between	quarel		choose_between
quarel_choose_between_score_eval	quarel		choose_between_score_eval
quarel_do_not_use	quarel		do_not_use
quarel_do_not_use_score_eval	quarel		do_not_use_score_eval
quarel_heres_a_story	quarel		heres_a_story
quarel_heres_a_story_score_eval	quarel		heres_a_story_score_eval
quarel_logic_test	quarel		logic_test
quarel_logic_test_score_eval	quarel		logic_test_score_eval
quarel_testing_students	quarel		testing_students
quarel_testing_students_score_eval	quarel		testing_students_score_eval
quartz_answer_question_based_on	quartz		answer_question_based_on
quartz_answer_question_based_on_score_eval	quartz		answer_question_based_on_score_eval
quartz_answer_question_below	quartz		answer_question_below
quartz_answer_question_below_score_eval	quartz		answer_question_below_score_eval
quartz_given_the_fact_answer_the_q	quartz		given_the_fact_answer_the_q
quartz_given_the_fact_answer_the_q_score_eval	quartz		given_the_fact_answer_the_q_score_eval
quartz_having_read_above_passage	quartz		having_read_above_passage
quartz_having_read_above_passage_score_eval	quartz		having_read_above_passage_score_eval
quartz_paragraph_question_plain_concat	quartz		paragraph_question_plain_concat
quartz_paragraph_question_plain_concat_score_eval	quartz		paragraph_question_plain_concat_score_eval
quartz_read_passage_below_choose	quartz		read_passage_below_choose
quartz_read_passage_below_choose_score_eval	quartz		read_passage_below_choose_score_eval
quartz_use_info_from_paragraph_question	quartz		use_info_from_paragraph_question
quartz_use_info_from_paragraph_question_score_eval	quartz		use_info_from_paragraph_question_score_eval
quartz_use_info_from_question_paragraph	quartz		use_info_from_question_paragraph
quartz_use_info_from_question_paragraph_score_eval	quartz		use_info_from_question_paragraph_score_eval
quoref_Answer_Friend_Question	quoref		Answer Friend Question
quoref_Answer_Friend_Question_score_eval	quoref		Answer Friend Question_score_eval
quoref_Answer_Question_Given_Context	quoref		Answer Question Given Context
quoref_Answer_Question_Given_Context_score_eval	quoref		Answer Question Given Context_score_eval
quoref_Answer_Test	quoref		Answer Test
quoref_Answer_Test_score_eval	quoref		Answer Test_score_eval
quoref_Context_Contains_Answer	quoref		Context Contains Answer
quoref_Context_Contains_Answer_score_eval	quoref		Context Contains Answer_score_eval
quoref_Find_Answer	quoref		Find Answer
quoref_Find_Answer_score_eval	quoref		Find Answer_score_eval
quoref_Found_Context_Online	quoref		Found Context Online
quoref_Found_Context_Online_score_eval	quoref		Found Context Online_score_eval
quoref_Given_Context_Answer_Question	quoref		Given Context Answer Question
quoref_Given_Context_Answer_Question_score_eval	quoref		Given Context Answer Question_score_eval
quoref_Guess_Answer	quoref		Guess Answer
quoref_Guess_Answer_score_eval	quoref		Guess Answer_score_eval
quoref_Guess_Title_For_Context	quoref		Guess Title For Context
quoref_Guess_Title_For_Context_score_eval	quoref		Guess Title For Context_score_eval
quoref_Read_And_Extract_	quoref		Read And Extract 
quoref_Read_And_Extract__score_eval	quoref		Read And Extract _score_eval
quoref_What_Is_The_Answer	quoref		What Is The Answer
quoref_What_Is_The_Answer_score_eval	quoref		What Is The Answer_score_eval
race_high_Is_this_the_right_answer	race	high	Is this the right answer
race_high_Is_this_the_right_answer_score_eval	race	high	Is this the right answer_score_eval
race_high_Read_the_article_and_answer_the_question_no_option_	race	high	Read the article and answer the question (no option)
race_high_Read_the_article_and_answer_the_question_no_option__score_eval	race	high	Read the article and answer the question (no option)_score_eval
race_high_Select_the_best_answer	race	high	Select the best answer
race_high_Select_the_best_answer_generate_span_	race	high	Select the best answer (generate span)
race_high_Select_the_best_answer_generate_span__score_eval	race	high	Select the best answer (generate span)_score_eval
race_high_Select_the_best_answer_no_instructions_	race	high	Select the best answer (no instructions)
race_high_Select_the_best_answer_no_instructions__score_eval	race	high	Select the best answer (no instructions)_score_eval
race_high_Select_the_best_answer_score_eval	race	high	Select the best answer_score_eval
race_high_Taking_a_test	race	high	Taking a test
race_high_Taking_a_test_score_eval	race	high	Taking a test_score_eval
race_high_Write_a_multi_choice_question_for_the_following_article	race	high	Write a multi-choice question for the following article
race_high_Write_a_multi_choice_question_for_the_following_article_score_eval	race	high	Write a multi-choice question for the following article_score_eval
race_high_Write_a_multi_choice_question_options_given_	race	high	Write a multi-choice question (options given)
race_high_Write_a_multi_choice_question_options_given__score_eval	race	high	Write a multi-choice question (options given)_score_eval
race_middle_Is_this_the_right_answer	race	middle	Is this the right answer
race_middle_Is_this_the_right_answer_score_eval	race	middle	Is this the right answer_score_eval
race_middle_Read_the_article_and_answer_the_question_no_option_	race	middle	Read the article and answer the question (no option)
race_middle_Read_the_article_and_answer_the_question_no_option__score_eval	race	middle	Read the article and answer the question (no option)_score_eval
race_middle_Select_the_best_answer	race	middle	Select the best answer
race_middle_Select_the_best_answer_generate_span_	race	middle	Select the best answer (generate span)
race_middle_Select_the_best_answer_generate_span__score_eval	race	middle	Select the best answer (generate span)_score_eval
race_middle_Select_the_best_answer_no_instructions_	race	middle	Select the best answer (no instructions)
race_middle_Select_the_best_answer_no_instructions__score_eval	race	middle	Select the best answer (no instructions)_score_eval
race_middle_Select_the_best_answer_score_eval	race	middle	Select the best answer_score_eval
race_middle_Taking_a_test	race	middle	Taking a test
race_middle_Taking_a_test_score_eval	race	middle	Taking a test_score_eval
race_middle_Write_a_multi_choice_question_for_the_following_article	race	middle	Write a multi-choice question for the following article
race_middle_Write_a_multi_choice_question_for_the_following_article_score_eval	race	middle	Write a multi-choice question for the following article_score_eval
race_middle_Write_a_multi_choice_question_options_given_	race	middle	Write a multi-choice question (options given)
race_middle_Write_a_multi_choice_question_options_given__score_eval	race	middle	Write a multi-choice question (options given)_score_eval
ropes_background_new_situation_answer	ropes		background_new_situation_answer
ropes_background_new_situation_answer_score_eval	ropes		background_new_situation_answer_score_eval
ropes_background_situation_middle	ropes		background_situation_middle
ropes_background_situation_middle_score_eval	ropes		background_situation_middle_score_eval
ropes_given_background_situation	ropes		given_background_situation
ropes_given_background_situation_score_eval	ropes		given_background_situation_score_eval
ropes_new_situation_background_answer	ropes		new_situation_background_answer
ropes_new_situation_background_answer_score_eval	ropes		new_situation_background_answer_score_eval
ropes_plain_background_situation	ropes		plain_background_situation
ropes_plain_background_situation_score_eval	ropes		plain_background_situation_score_eval
ropes_plain_bottom_hint	ropes		plain_bottom_hint
ropes_plain_bottom_hint_score_eval	ropes		plain_bottom_hint_score_eval
ropes_plain_no_background	ropes		plain_no_background
ropes_plain_no_background_score_eval	ropes		plain_no_background_score_eval
ropes_prompt_beginning	ropes		prompt_beginning
ropes_prompt_beginning_score_eval	ropes		prompt_beginning_score_eval
ropes_prompt_bottom_hint_beginning	ropes		prompt_bottom_hint_beginning
ropes_prompt_bottom_hint_beginning_score_eval	ropes		prompt_bottom_hint_beginning_score_eval
ropes_prompt_bottom_no_hint	ropes		prompt_bottom_no_hint
ropes_prompt_bottom_no_hint_score_eval	ropes		prompt_bottom_no_hint_score_eval
ropes_prompt_mix	ropes		prompt_mix
ropes_prompt_mix_score_eval	ropes		prompt_mix_score_eval
ropes_read_background_situation	ropes		read_background_situation
ropes_read_background_situation_score_eval	ropes		read_background_situation_score_eval
rotten_tomatoes_Movie_Expressed_Sentiment	rotten_tomatoes		Movie Expressed Sentiment
rotten_tomatoes_Movie_Expressed_Sentiment_2	rotten_tomatoes		Movie Expressed Sentiment 2
rotten_tomatoes_Movie_Expressed_Sentiment_2_score_eval	rotten_tomatoes		Movie Expressed Sentiment 2_score_eval
rotten_tomatoes_Movie_Expressed_Sentiment_score_eval	rotten_tomatoes		Movie Expressed Sentiment_score_eval
rotten_tomatoes_Reviewer_Enjoyment	rotten_tomatoes		Reviewer Enjoyment
rotten_tomatoes_Reviewer_Enjoyment_Yes_No	rotten_tomatoes		Reviewer Enjoyment Yes No
rotten_tomatoes_Reviewer_Enjoyment_Yes_No_score_eval	rotten_tomatoes		Reviewer Enjoyment Yes No_score_eval
rotten_tomatoes_Reviewer_Enjoyment_score_eval	rotten_tomatoes		Reviewer Enjoyment_score_eval
rotten_tomatoes_Reviewer_Expressed_Sentiment	rotten_tomatoes		Reviewer Expressed Sentiment
rotten_tomatoes_Reviewer_Expressed_Sentiment_score_eval	rotten_tomatoes		Reviewer Expressed Sentiment_score_eval
rotten_tomatoes_Reviewer_Opinion_bad_good_choices	rotten_tomatoes		Reviewer Opinion bad good choices
rotten_tomatoes_Reviewer_Opinion_bad_good_choices_score_eval	rotten_tomatoes		Reviewer Opinion bad good choices_score_eval
rotten_tomatoes_Reviewer_Sentiment_Feeling	rotten_tomatoes		Reviewer Sentiment Feeling
rotten_tomatoes_Reviewer_Sentiment_Feeling_score_eval	rotten_tomatoes		Reviewer Sentiment Feeling_score_eval
rotten_tomatoes_Sentiment_with_choices_	rotten_tomatoes		Sentiment with choices 
rotten_tomatoes_Sentiment_with_choices__score_eval	rotten_tomatoes		Sentiment with choices _score_eval
rotten_tomatoes_Text_Expressed_Sentiment	rotten_tomatoes		Text Expressed Sentiment
rotten_tomatoes_Text_Expressed_Sentiment_score_eval	rotten_tomatoes		Text Expressed Sentiment_score_eval
rotten_tomatoes_Writer_Expressed_Sentiment	rotten_tomatoes		Writer Expressed Sentiment
rotten_tomatoes_Writer_Expressed_Sentiment_score_eval	rotten_tomatoes		Writer Expressed Sentiment_score_eval
samsum_Generate_a_summary_for_this_dialogue	samsum		Generate a summary for this dialogue
samsum_Generate_a_summary_for_this_dialogue_score_eval	samsum		Generate a summary for this dialogue_score_eval
samsum_Given_the_above_dialogue_write_a_summary	samsum		Given the above dialogue write a summary
samsum_Given_the_above_dialogue_write_a_summary_score_eval	samsum		Given the above dialogue write a summary_score_eval
samsum_Sum_up_the_following_dialogue	samsum		Sum up the following dialogue
samsum_Sum_up_the_following_dialogue_score_eval	samsum		Sum up the following dialogue_score_eval
samsum_Summarize_	samsum		Summarize:
samsum_Summarize__score_eval	samsum		Summarize:_score_eval
samsum_Summarize_this_dialogue_	samsum		Summarize this dialogue:
samsum_Summarize_this_dialogue__score_eval	samsum		Summarize this dialogue:_score_eval
samsum_To_sum_up_this_dialog	samsum		To sum up this dialog
samsum_To_sum_up_this_dialog_score_eval	samsum		To sum up this dialog_score_eval
samsum_Write_a_dialogue_that_match_this_summary	samsum		Write a dialogue that match this summary
samsum_Write_a_dialogue_that_match_this_summary_score_eval	samsum		Write a dialogue that match this summary_score_eval
sciq_Direct_Question	sciq		Direct Question
sciq_Direct_Question_Closed_Book_	sciq		Direct Question (Closed Book)
sciq_Direct_Question_Closed_Book__score_eval	sciq		Direct Question (Closed Book)_score_eval
sciq_Direct_Question_score_eval	sciq		Direct Question_score_eval
sciq_Multiple_Choice	sciq		Multiple Choice
sciq_Multiple_Choice_Closed_Book_	sciq		Multiple Choice (Closed Book)
sciq_Multiple_Choice_Closed_Book__score_eval	sciq		Multiple Choice (Closed Book)_score_eval
sciq_Multiple_Choice_Question_First	sciq		Multiple Choice Question First
sciq_Multiple_Choice_Question_First_score_eval	sciq		Multiple Choice Question First_score_eval
sciq_Multiple_Choice_score_eval	sciq		Multiple Choice_score_eval
social_i_qa_Check_if_a_random_answer_is_valid_or_not	social_i_qa		Check if a random answer is valid or not
social_i_qa_Check_if_a_random_answer_is_valid_or_not_score_eval	social_i_qa		Check if a random answer is valid or not_score_eval
social_i_qa_Generate_answer	social_i_qa		Generate answer
social_i_qa_Generate_answer_score_eval	social_i_qa		Generate answer_score_eval
social_i_qa_Generate_the_question_from_the_answer	social_i_qa		Generate the question from the answer
social_i_qa_Generate_the_question_from_the_answer_score_eval	social_i_qa		Generate the question from the answer_score_eval
social_i_qa_I_was_wondering	social_i_qa		I was wondering
social_i_qa_I_was_wondering_score_eval	social_i_qa		I was wondering_score_eval
social_i_qa_Show_choices_and_generate_answer	social_i_qa		Show choices and generate answer
social_i_qa_Show_choices_and_generate_answer_score_eval	social_i_qa		Show choices and generate answer_score_eval
social_i_qa_Show_choices_and_generate_index	social_i_qa		Show choices and generate index
social_i_qa_Show_choices_and_generate_index_score_eval	social_i_qa		Show choices and generate index_score_eval
squad_v2_Jeopardy_with_Context	squad_v2		Jeopardy with Context
squad_v2_Jeopardy_with_Context_score_eval	squad_v2		Jeopardy with Context_score_eval
squad_v2_Jeopardy_without_Context	squad_v2		Jeopardy without Context
squad_v2_Jeopardy_without_Context_score_eval	squad_v2		Jeopardy without Context_score_eval
squad_v2_Questions_with_Context	squad_v2		Questions with Context
squad_v2_Questions_with_Context_Without_Prompt_Keywords	squad_v2		Questions with Context - Without Prompt Keywords
squad_v2_Questions_with_Context_Without_Prompt_Keywords_score_eval	squad_v2		Questions with Context - Without Prompt Keywords_score_eval
squad_v2_Questions_with_Context_Without_Prompt_Keywords_unanswerable	squad_v2		Questions with Context - Without Prompt Keywords +unanswerable
squad_v2_Questions_with_Context_Without_Prompt_Keywords_unanswerable_score_eval	squad_v2		Questions with Context - Without Prompt Keywords +unanswerable_score_eval
squad_v2_Questions_with_Context_score_eval	squad_v2		Questions with Context_score_eval
squad_v2_Questions_with_Context_unanswerable	squad_v2		Questions with Context +unanswerable
squad_v2_Questions_with_Context_unanswerable_score_eval	squad_v2		Questions with Context +unanswerable_score_eval
squad_v2_Topic_Prediction_Context	squad_v2		Topic Prediction - Context
squad_v2_Topic_Prediction_Context_score_eval	squad_v2		Topic Prediction - Context_score_eval
squad_v2_Topic_Prediction_Context_with_randomized_prompt_options	squad_v2		Topic Prediction - Context with randomized prompt options
squad_v2_Topic_Prediction_Context_with_randomized_prompt_options_placed_in_the_end	squad_v2		Topic Prediction - Context with randomized prompt options placed in the end
squad_v2_Topic_Prediction_Context_with_randomized_prompt_options_placed_in_the_end_score_eval	squad_v2		Topic Prediction - Context with randomized prompt options placed in the end_score_eval
squad_v2_Topic_Prediction_Context_with_randomized_prompt_options_score_eval	squad_v2		Topic Prediction - Context with randomized prompt options_score_eval
squad_v2_Topic_Prediction_Question_and_Answer_Pair	squad_v2		Topic Prediction - Question and Answer Pair
squad_v2_Topic_Prediction_Question_and_Answer_Pair_score_eval	squad_v2		Topic Prediction - Question and Answer Pair_score_eval
squad_v2_Trivia	squad_v2		Trivia
squad_v2_Trivia_score_eval	squad_v2		Trivia_score_eval
squad_v2_Unanwerable_question	squad_v2		Unanwerable question
squad_v2_Unanwerable_question_score_eval	squad_v2		Unanwerable question_score_eval
story_cloze_2016_Answer_Given_options	story_cloze	2016	Answer Given options
story_cloze_2016_Answer_Given_options_score_eval	story_cloze	2016	Answer Given options_score_eval
story_cloze_2016_Choose_Story_Ending	story_cloze	2016	Choose Story Ending
story_cloze_2016_Choose_Story_Ending_score_eval	story_cloze	2016	Choose Story Ending_score_eval
story_cloze_2016_Generate_Ending	story_cloze	2016	Generate Ending
story_cloze_2016_Generate_Ending_score_eval	story_cloze	2016	Generate Ending_score_eval
story_cloze_2016_Movie_What_Happens_Next	story_cloze	2016	Movie What Happens Next
story_cloze_2016_Movie_What_Happens_Next_score_eval	story_cloze	2016	Movie What Happens Next_score_eval
story_cloze_2016_Novel_Correct_Ending	story_cloze	2016	Novel Correct Ending
story_cloze_2016_Novel_Correct_Ending_score_eval	story_cloze	2016	Novel Correct Ending_score_eval
story_cloze_2016_Story_Continuation_and_Options	story_cloze	2016	Story Continuation and Options
story_cloze_2016_Story_Continuation_and_Options_score_eval	story_cloze	2016	Story Continuation and Options_score_eval
super_glue_axb_GPT_3_style	super_glue	axb	GPT-3 style
super_glue_axb_GPT_3_style_score_eval	super_glue	axb	GPT-3 style_score_eval
super_glue_axb_MNLI_crowdsource	super_glue	axb	MNLI crowdsource
super_glue_axb_MNLI_crowdsource_score_eval	super_glue	axb	MNLI crowdsource_score_eval
super_glue_axb_based_on_the_previous_passage	super_glue	axb	based on the previous passage
super_glue_axb_based_on_the_previous_passage_score_eval	super_glue	axb	based on the previous passage_score_eval
super_glue_axb_can_we_infer	super_glue	axb	can we infer
super_glue_axb_can_we_infer_score_eval	super_glue	axb	can we infer_score_eval
super_glue_axb_does_it_follow_that	super_glue	axb	does it follow that
super_glue_axb_does_it_follow_that_score_eval	super_glue	axb	does it follow that_score_eval
super_glue_axb_does_this_imply	super_glue	axb	does this imply
super_glue_axb_does_this_imply_score_eval	super_glue	axb	does this imply_score_eval
super_glue_axb_guaranteed_true	super_glue	axb	guaranteed true
super_glue_axb_guaranteed_true_score_eval	super_glue	axb	guaranteed true_score_eval
super_glue_axb_justified_in_saying	super_glue	axb	justified in saying
super_glue_axb_justified_in_saying_score_eval	super_glue	axb	justified in saying_score_eval
super_glue_axb_must_be_true	super_glue	axb	must be true
super_glue_axb_must_be_true_score_eval	super_glue	axb	must be true_score_eval
super_glue_axb_should_assume	super_glue	axb	should assume
super_glue_axb_should_assume_score_eval	super_glue	axb	should assume_score_eval
super_glue_axg_GPT_3_style	super_glue	axg	GPT-3 style
super_glue_axg_GPT_3_style_score_eval	super_glue	axg	GPT-3 style_score_eval
super_glue_axg_MNLI_crowdsource	super_glue	axg	MNLI crowdsource
super_glue_axg_MNLI_crowdsource_score_eval	super_glue	axg	MNLI crowdsource_score_eval
super_glue_axg_based_on_the_previous_passage	super_glue	axg	based on the previous passage
super_glue_axg_based_on_the_previous_passage_score_eval	super_glue	axg	based on the previous passage_score_eval
super_glue_axg_can_we_infer	super_glue	axg	can we infer
super_glue_axg_can_we_infer_score_eval	super_glue	axg	can we infer_score_eval
super_glue_axg_does_it_follow_that	super_glue	axg	does it follow that
super_glue_axg_does_it_follow_that_score_eval	super_glue	axg	does it follow that_score_eval
super_glue_axg_does_this_imply	super_glue	axg	does this imply
super_glue_axg_does_this_imply_score_eval	super_glue	axg	does this imply_score_eval
super_glue_axg_guaranteed_true	super_glue	axg	guaranteed true
super_glue_axg_guaranteed_true_score_eval	super_glue	axg	guaranteed true_score_eval
super_glue_axg_justified_in_saying	super_glue	axg	justified in saying
super_glue_axg_justified_in_saying_score_eval	super_glue	axg	justified in saying_score_eval
super_glue_axg_must_be_true	super_glue	axg	must be true
super_glue_axg_must_be_true_score_eval	super_glue	axg	must be true_score_eval
super_glue_axg_should_assume	super_glue	axg	should assume
super_glue_axg_should_assume_score_eval	super_glue	axg	should assume_score_eval
super_glue_boolq_GPT_3_Style	super_glue	boolq	GPT-3 Style
super_glue_boolq_GPT_3_Style_score_eval	super_glue	boolq	GPT-3 Style_score_eval
super_glue_boolq_I_wonder_	super_glue	boolq	I wonder…
super_glue_boolq_I_wonder__score_eval	super_glue	boolq	I wonder…_score_eval
super_glue_boolq_after_reading	super_glue	boolq	after_reading
super_glue_boolq_after_reading_score_eval	super_glue	boolq	after_reading_score_eval
super_glue_boolq_based_on_the_following_passage	super_glue	boolq	based on the following passage
super_glue_boolq_based_on_the_following_passage_score_eval	super_glue	boolq	based on the following passage_score_eval
super_glue_boolq_based_on_the_previous_passage	super_glue	boolq	based on the previous passage
super_glue_boolq_based_on_the_previous_passage_score_eval	super_glue	boolq	based on the previous passage_score_eval
super_glue_boolq_could_you_tell_me_	super_glue	boolq	could you tell me…
super_glue_boolq_could_you_tell_me__score_eval	super_glue	boolq	could you tell me…_score_eval
super_glue_boolq_exam	super_glue	boolq	exam
super_glue_boolq_exam_score_eval	super_glue	boolq	exam_score_eval
super_glue_boolq_exercise	super_glue	boolq	exercise
super_glue_boolq_exercise_score_eval	super_glue	boolq	exercise_score_eval
super_glue_boolq_valid_binary	super_glue	boolq	valid_binary
super_glue_boolq_valid_binary_score_eval	super_glue	boolq	valid_binary_score_eval
super_glue_boolq_yes_no_question	super_glue	boolq	yes_no_question
super_glue_boolq_yes_no_question_score_eval	super_glue	boolq	yes_no_question_score_eval
super_glue_cb_GPT_3_style	super_glue	cb	GPT-3 style
super_glue_cb_GPT_3_style_score_eval	super_glue	cb	GPT-3 style_score_eval
super_glue_cb_MNLI_crowdsource	super_glue	cb	MNLI crowdsource
super_glue_cb_MNLI_crowdsource_score_eval	super_glue	cb	MNLI crowdsource_score_eval
super_glue_cb_always_sometimes_never	super_glue	cb	always/sometimes/never
super_glue_cb_always_sometimes_never_score_eval	super_glue	cb	always/sometimes/never_score_eval
super_glue_cb_based_on_the_previous_passage	super_glue	cb	based on the previous passage
super_glue_cb_based_on_the_previous_passage_score_eval	super_glue	cb	based on the previous passage_score_eval
super_glue_cb_can_we_infer	super_glue	cb	can we infer
super_glue_cb_can_we_infer_score_eval	super_glue	cb	can we infer_score_eval
super_glue_cb_claim_true_false_inconclusive	super_glue	cb	claim true/false/inconclusive
super_glue_cb_claim_true_false_inconclusive_score_eval	super_glue	cb	claim true/false/inconclusive_score_eval
super_glue_cb_consider_always_sometimes_never	super_glue	cb	consider always/sometimes/never
super_glue_cb_consider_always_sometimes_never_score_eval	super_glue	cb	consider always/sometimes/never_score_eval
super_glue_cb_does_it_follow_that	super_glue	cb	does it follow that
super_glue_cb_does_it_follow_that_score_eval	super_glue	cb	does it follow that_score_eval
super_glue_cb_does_this_imply	super_glue	cb	does this imply
super_glue_cb_does_this_imply_score_eval	super_glue	cb	does this imply_score_eval
super_glue_cb_guaranteed_possible_impossible	super_glue	cb	guaranteed/possible/impossible
super_glue_cb_guaranteed_possible_impossible_score_eval	super_glue	cb	guaranteed/possible/impossible_score_eval
super_glue_cb_guaranteed_true	super_glue	cb	guaranteed true
super_glue_cb_guaranteed_true_score_eval	super_glue	cb	guaranteed true_score_eval
super_glue_cb_justified_in_saying	super_glue	cb	justified in saying
super_glue_cb_justified_in_saying_score_eval	super_glue	cb	justified in saying_score_eval
super_glue_cb_must_be_true	super_glue	cb	must be true
super_glue_cb_must_be_true_score_eval	super_glue	cb	must be true_score_eval
super_glue_cb_should_assume	super_glue	cb	should assume
super_glue_cb_should_assume_score_eval	super_glue	cb	should assume_score_eval
super_glue_cb_take_the_following_as_truth	super_glue	cb	take the following as truth
super_glue_cb_take_the_following_as_truth_score_eval	super_glue	cb	take the following as truth_score_eval
super_glue_copa_C1_or_C2_premise_so_because_	super_glue	copa	C1 or C2? premise, so/because…
super_glue_copa_C1_or_C2_premise_so_because__score_eval	super_glue	copa	C1 or C2? premise, so/because…_score_eval
super_glue_copa__As_a_result_C1_or_C2_	super_glue	copa	…As a result, C1 or C2?
super_glue_copa__As_a_result_C1_or_C2__score_eval	super_glue	copa	…As a result, C1 or C2?_score_eval
super_glue_copa__What_could_happen_next_C1_or_C2_	super_glue	copa	…What could happen next, C1 or C2?
super_glue_copa__What_could_happen_next_C1_or_C2__score_eval	super_glue	copa	…What could happen next, C1 or C2?_score_eval
super_glue_copa__which_may_be_caused_by	super_glue	copa	…which may be caused by
super_glue_copa__which_may_be_caused_by_score_eval	super_glue	copa	…which may be caused by_score_eval
super_glue_copa__why_C1_or_C2	super_glue	copa	…why? C1 or C2
super_glue_copa__why_C1_or_C2_score_eval	super_glue	copa	…why? C1 or C2_score_eval
super_glue_copa_best_option	super_glue	copa	best_option
super_glue_copa_best_option_score_eval	super_glue	copa	best_option_score_eval
super_glue_copa_cause_effect	super_glue	copa	cause_effect
super_glue_copa_cause_effect_score_eval	super_glue	copa	cause_effect_score_eval
super_glue_copa_choose	super_glue	copa	choose
super_glue_copa_choose_score_eval	super_glue	copa	choose_score_eval
super_glue_copa_exercise	super_glue	copa	exercise
super_glue_copa_exercise_score_eval	super_glue	copa	exercise_score_eval
super_glue_copa_i_am_hesitating	super_glue	copa	i_am_hesitating
super_glue_copa_i_am_hesitating_score_eval	super_glue	copa	i_am_hesitating_score_eval
super_glue_copa_more_likely	super_glue	copa	more likely
super_glue_copa_more_likely_score_eval	super_glue	copa	more likely_score_eval
super_glue_copa_plausible_alternatives	super_glue	copa	plausible_alternatives
super_glue_copa_plausible_alternatives_score_eval	super_glue	copa	plausible_alternatives_score_eval
super_glue_multirc_I_was_going_to_say_	super_glue	multirc	I was going to say…
super_glue_multirc_I_was_going_to_say__score_eval	super_glue	multirc	I was going to say…_score_eval
super_glue_multirc_Would_it_be_good_to_answer_	super_glue	multirc	Would it be good to answer…
super_glue_multirc_Would_it_be_good_to_answer__score_eval	super_glue	multirc	Would it be good to answer…_score_eval
super_glue_multirc_confirm	super_glue	multirc	confirm
super_glue_multirc_confirm_score_eval	super_glue	multirc	confirm_score_eval
super_glue_multirc_correct	super_glue	multirc	correct
super_glue_multirc_correct_score_eval	super_glue	multirc	correct_score_eval
super_glue_multirc_decide_valid	super_glue	multirc	decide_valid
super_glue_multirc_decide_valid_score_eval	super_glue	multirc	decide_valid_score_eval
super_glue_multirc_found_this_answer	super_glue	multirc	found_this_answer
super_glue_multirc_found_this_answer_score_eval	super_glue	multirc	found_this_answer_score_eval
super_glue_multirc_grading	super_glue	multirc	grading
super_glue_multirc_grading_score_eval	super_glue	multirc	grading_score_eval
super_glue_multirc_is_a_correct_answer_	super_glue	multirc	is… a correct answer?
super_glue_multirc_is_a_correct_answer__score_eval	super_glue	multirc	is… a correct answer?_score_eval
super_glue_multirc_is_the_correct_answer_	super_glue	multirc	is the correct answer…
super_glue_multirc_is_the_correct_answer__score_eval	super_glue	multirc	is the correct answer…_score_eval
super_glue_multirc_paragraph_question_is_it_	super_glue	multirc	paragraph… question… is it… ?
super_glue_multirc_paragraph_question_is_it__score_eval	super_glue	multirc	paragraph… question… is it… ?_score_eval
super_glue_record_Add_sentence_after_after_continuation_choices_	super_glue	record	Add sentence after after (continuation choices)
super_glue_record_Add_sentence_after_after_continuation_choices__score_eval	super_glue	record	Add sentence after after (continuation choices)_score_eval
super_glue_record_Add_sentence_after_continuation_choices_	super_glue	record	Add sentence after (continuation choices)
super_glue_record_Add_sentence_after_continuation_choices__score_eval	super_glue	record	Add sentence after (continuation choices)_score_eval
super_glue_record_Can_you_figure_out_	super_glue	record	Can you figure out…
super_glue_record_Can_you_figure_out__score_eval	super_glue	record	Can you figure out…_score_eval
super_glue_record_GPT_3_style_continuation_choices_	super_glue	record	GPT-3 style (continuation choices)
super_glue_record_GPT_3_style_continuation_choices__score_eval	super_glue	record	GPT-3 style (continuation choices)_score_eval
super_glue_record_GPT_3_style_summary_only_continuation_choices_	super_glue	record	GPT-3 style summary only (continuation choices)
super_glue_record_GPT_3_style_summary_only_continuation_choices__score_eval	super_glue	record	GPT-3 style summary only (continuation choices)_score_eval
super_glue_record_GPT_3_style_with_labels_continuation_choices_	super_glue	record	GPT-3 style with labels (continuation choices)
super_glue_record_GPT_3_style_with_labels_continuation_choices__score_eval	super_glue	record	GPT-3 style with labels (continuation choices)_score_eval
super_glue_record_GPT_3_style_with_labels_without_hyphens_continuation_choices_	super_glue	record	GPT-3 style with labels without hyphens (continuation choices)
super_glue_record_GPT_3_style_with_labels_without_hyphens_continuation_choices__score_eval	super_glue	record	GPT-3 style with labels without hyphens (continuation choices)_score_eval
super_glue_record_GPT_3_style_without_hyphens_continuation_choices_	super_glue	record	GPT-3 style without hyphens (continuation choices)
super_glue_record_GPT_3_style_without_hyphens_continuation_choices__score_eval	super_glue	record	GPT-3 style without hyphens (continuation choices)_score_eval
super_glue_record_In_the_question_above_the_placeholder_stands_for	super_glue	record	In the question above, the placeholder stands for
super_glue_record_In_the_question_above_the_placeholder_stands_for_score_eval	super_glue	record	In the question above, the placeholder stands for_score_eval
super_glue_record_New_highlight_continuation_choices_	super_glue	record	New highlight (continuation choices)
super_glue_record_New_highlight_continuation_choices__score_eval	super_glue	record	New highlight (continuation choices)_score_eval
super_glue_record_News_article_continuation_choices_	super_glue	record	News article (continuation choices)
super_glue_record_News_article_continuation_choices__score_eval	super_glue	record	News article (continuation choices)_score_eval
super_glue_record_Summary_first_continuation_choices_	super_glue	record	Summary first (continuation choices)
super_glue_record_Summary_first_continuation_choices__score_eval	super_glue	record	Summary first (continuation choices)_score_eval
super_glue_record_What_could_the_placeholder_be_	super_glue	record	What could the placeholder be?
super_glue_record_What_could_the_placeholder_be__score_eval	super_glue	record	What could the placeholder be?_score_eval
super_glue_record_Which_one_is_the_placeholder_	super_glue	record	Which one is the placeholder?
super_glue_record_Which_one_is_the_placeholder__score_eval	super_glue	record	Which one is the placeholder?_score_eval
super_glue_record_choose_between	super_glue	record	choose_between
super_glue_record_choose_between_score_eval	super_glue	record	choose_between_score_eval
super_glue_record_corrupted	super_glue	record	corrupted
super_glue_record_corrupted_score_eval	super_glue	record	corrupted_score_eval
super_glue_record_exercise	super_glue	record	exercise
super_glue_record_exercise_score_eval	super_glue	record	exercise_score_eval
super_glue_record_pick_one_option	super_glue	record	pick_one_option
super_glue_record_pick_one_option_score_eval	super_glue	record	pick_one_option_score_eval
super_glue_record_the_placeholder_refers_to_	super_glue	record	the placeholder refers to…
super_glue_record_the_placeholder_refers_to__score_eval	super_glue	record	the placeholder refers to…_score_eval
super_glue_record_trying_to_decide	super_glue	record	trying_to_decide
super_glue_record_trying_to_decide_score_eval	super_glue	record	trying_to_decide_score_eval
super_glue_rte_GPT_3_style	super_glue	rte	GPT-3 style
super_glue_rte_GPT_3_style_score_eval	super_glue	rte	GPT-3 style_score_eval
super_glue_rte_MNLI_crowdsource	super_glue	rte	MNLI crowdsource
super_glue_rte_MNLI_crowdsource_score_eval	super_glue	rte	MNLI crowdsource_score_eval
super_glue_rte_based_on_the_previous_passage	super_glue	rte	based on the previous passage
super_glue_rte_based_on_the_previous_passage_score_eval	super_glue	rte	based on the previous passage_score_eval
super_glue_rte_can_we_infer	super_glue	rte	can we infer
super_glue_rte_can_we_infer_score_eval	super_glue	rte	can we infer_score_eval
super_glue_rte_does_it_follow_that	super_glue	rte	does it follow that
super_glue_rte_does_it_follow_that_score_eval	super_glue	rte	does it follow that_score_eval
super_glue_rte_does_this_imply	super_glue	rte	does this imply
super_glue_rte_does_this_imply_score_eval	super_glue	rte	does this imply_score_eval
super_glue_rte_guaranteed_true	super_glue	rte	guaranteed true
super_glue_rte_guaranteed_true_score_eval	super_glue	rte	guaranteed true_score_eval
super_glue_rte_justified_in_saying	super_glue	rte	justified in saying
super_glue_rte_justified_in_saying_score_eval	super_glue	rte	justified in saying_score_eval
super_glue_rte_must_be_true	super_glue	rte	must be true
super_glue_rte_must_be_true_score_eval	super_glue	rte	must be true_score_eval
super_glue_rte_should_assume	super_glue	rte	should assume
super_glue_rte_should_assume_score_eval	super_glue	rte	should assume_score_eval
super_glue_wic_GPT_3_prompt	super_glue	wic	GPT-3-prompt
super_glue_wic_GPT_3_prompt_score_eval	super_glue	wic	GPT-3-prompt_score_eval
super_glue_wic_GPT_3_prompt_with_label	super_glue	wic	GPT-3-prompt-with-label
super_glue_wic_GPT_3_prompt_with_label_score_eval	super_glue	wic	GPT-3-prompt-with-label_score_eval
super_glue_wic_affirmation_true_or_false	super_glue	wic	affirmation_true_or_false
super_glue_wic_affirmation_true_or_false_score_eval	super_glue	wic	affirmation_true_or_false_score_eval
super_glue_wic_grammar_homework	super_glue	wic	grammar_homework
super_glue_wic_grammar_homework_score_eval	super_glue	wic	grammar_homework_score_eval
super_glue_wic_polysemous	super_glue	wic	polysemous
super_glue_wic_polysemous_score_eval	super_glue	wic	polysemous_score_eval
super_glue_wic_question_context	super_glue	wic	question-context
super_glue_wic_question_context_meaning	super_glue	wic	question-context-meaning
super_glue_wic_question_context_meaning_score_eval	super_glue	wic	question-context-meaning_score_eval
super_glue_wic_question_context_meaning_with_label	super_glue	wic	question-context-meaning-with-label
super_glue_wic_question_context_meaning_with_label_score_eval	super_glue	wic	question-context-meaning-with-label_score_eval
super_glue_wic_question_context_score_eval	super_glue	wic	question-context_score_eval
super_glue_wic_same_sense	super_glue	wic	same_sense
super_glue_wic_same_sense_score_eval	super_glue	wic	same_sense_score_eval
super_glue_wic_similar_sense	super_glue	wic	similar-sense
super_glue_wic_similar_sense_score_eval	super_glue	wic	similar-sense_score_eval
super_glue_wsc.fixed_GPT_3_Style	super_glue	wsc.fixed	GPT-3 Style
super_glue_wsc.fixed_GPT_3_Style_score_eval	super_glue	wsc.fixed	GPT-3 Style_score_eval
super_glue_wsc.fixed_I_think_they_mean	super_glue	wsc.fixed	I think they mean
super_glue_wsc.fixed_I_think_they_mean_score_eval	super_glue	wsc.fixed	I think they mean_score_eval
super_glue_wsc.fixed_Who_or_what_is_are	super_glue	wsc.fixed	Who or what is/are
super_glue_wsc.fixed_Who_or_what_is_are_score_eval	super_glue	wsc.fixed	Who or what is/are_score_eval
super_glue_wsc.fixed_by_p_they_mean	super_glue	wsc.fixed	by p they mean
super_glue_wsc.fixed_by_p_they_mean_score_eval	super_glue	wsc.fixed	by p they mean_score_eval
super_glue_wsc.fixed_does_p_stand_for	super_glue	wsc.fixed	does p stand for
super_glue_wsc.fixed_does_p_stand_for_score_eval	super_glue	wsc.fixed	does p stand for_score_eval
super_glue_wsc.fixed_does_the_pronoun_refer_to	super_glue	wsc.fixed	does the pronoun refer to
super_glue_wsc.fixed_does_the_pronoun_refer_to_score_eval	super_glue	wsc.fixed	does the pronoun refer to_score_eval
super_glue_wsc.fixed_in_other_words	super_glue	wsc.fixed	in other words
super_glue_wsc.fixed_in_other_words_score_eval	super_glue	wsc.fixed	in other words_score_eval
super_glue_wsc.fixed_p_is_are_r	super_glue	wsc.fixed	p is/are r
super_glue_wsc.fixed_p_is_are_r_score_eval	super_glue	wsc.fixed	p is/are r_score_eval
super_glue_wsc.fixed_replaced_with	super_glue	wsc.fixed	replaced with
super_glue_wsc.fixed_replaced_with_score_eval	super_glue	wsc.fixed	replaced with_score_eval
super_glue_wsc.fixed_the_pronoun_refers_to	super_glue	wsc.fixed	the pronoun refers to
super_glue_wsc.fixed_the_pronoun_refers_to_score_eval	super_glue	wsc.fixed	the pronoun refers to_score_eval
trec_fine_grained_ABBR	trec		fine_grained_ABBR
trec_fine_grained_ABBR_context_first	trec		fine_grained_ABBR_context_first
trec_fine_grained_ABBR_context_first_score_eval	trec		fine_grained_ABBR_context_first_score_eval
trec_fine_grained_ABBR_score_eval	trec		fine_grained_ABBR_score_eval
trec_fine_grained_DESC	trec		fine_grained_DESC
trec_fine_grained_DESC_context_first	trec		fine_grained_DESC_context_first
trec_fine_grained_DESC_context_first_score_eval	trec		fine_grained_DESC_context_first_score_eval
trec_fine_grained_DESC_score_eval	trec		fine_grained_DESC_score_eval
trec_fine_grained_ENTY	trec		fine_grained_ENTY
trec_fine_grained_ENTY_score_eval	trec		fine_grained_ENTY_score_eval
trec_fine_grained_HUM	trec		fine_grained_HUM
trec_fine_grained_HUM_context_first	trec		fine_grained_HUM_context_first
trec_fine_grained_HUM_context_first_score_eval	trec		fine_grained_HUM_context_first_score_eval
trec_fine_grained_HUM_score_eval	trec		fine_grained_HUM_score_eval
trec_fine_grained_LOC	trec		fine_grained_LOC
trec_fine_grained_LOC_context_first	trec		fine_grained_LOC_context_first
trec_fine_grained_LOC_context_first_score_eval	trec		fine_grained_LOC_context_first_score_eval
trec_fine_grained_LOC_score_eval	trec		fine_grained_LOC_score_eval
trec_fine_grained_NUM	trec		fine_grained_NUM
trec_fine_grained_NUM_context_first	trec		fine_grained_NUM_context_first
trec_fine_grained_NUM_context_first_score_eval	trec		fine_grained_NUM_context_first_score_eval
trec_fine_grained_NUM_score_eval	trec		fine_grained_NUM_score_eval
trec_fine_grained_open	trec		fine_grained_open
trec_fine_grained_open_context_first	trec		fine_grained_open_context_first
trec_fine_grained_open_context_first_score_eval	trec		fine_grained_open_context_first_score_eval
trec_fine_grained_open_score_eval	trec		fine_grained_open_score_eval
trec_pick_the_best_descriptor	trec		pick_the_best_descriptor
trec_pick_the_best_descriptor_score_eval	trec		pick_the_best_descriptor_score_eval
trec_trec1	trec		trec1
trec_trec1_score_eval	trec		trec1_score_eval
trec_trec2	trec		trec2
trec_trec2_score_eval	trec		trec2_score_eval
trec_what_category_best_describe	trec		what_category_best_describe
trec_what_category_best_describe_score_eval	trec		what_category_best_describe_score_eval
trec_which_category_best_describes	trec		which_category_best_describes
trec_which_category_best_describes_score_eval	trec		which_category_best_describes_score_eval
trivia_qa_unfiltered_first_person_context	trivia_qa	unfiltered	first_person_context
trivia_qa_unfiltered_first_person_context_score_eval	trivia_qa	unfiltered	first_person_context_score_eval
trivia_qa_unfiltered_formal_description	trivia_qa	unfiltered	formal_description
trivia_qa_unfiltered_formal_description_score_eval	trivia_qa	unfiltered	formal_description_score_eval
trivia_qa_unfiltered_guess_question	trivia_qa	unfiltered	guess_question
trivia_qa_unfiltered_guess_question_score_eval	trivia_qa	unfiltered	guess_question_score_eval
trivia_qa_unfiltered_question_answer	trivia_qa	unfiltered	question_answer
trivia_qa_unfiltered_question_answer_score_eval	trivia_qa	unfiltered	question_answer_score_eval
trivia_qa_unfiltered_question_with_instruction	trivia_qa	unfiltered	question_with_instruction
trivia_qa_unfiltered_question_with_instruction_score_eval	trivia_qa	unfiltered	question_with_instruction_score_eval
web_questions_get_the_answer	web_questions		get_the_answer
web_questions_get_the_answer_score_eval	web_questions		get_the_answer_score_eval
web_questions_potential_correct_answer	web_questions		potential-correct-answer
web_questions_potential_correct_answer_score_eval	web_questions		potential-correct-answer_score_eval
web_questions_question_answer	web_questions		question-answer
web_questions_question_answer_score_eval	web_questions		question-answer_score_eval
web_questions_short_general_knowledge_q	web_questions		short_general_knowledge_q
web_questions_short_general_knowledge_q_score_eval	web_questions		short_general_knowledge_q_score_eval
web_questions_whats_the_answer	web_questions		whats_the_answer
web_questions_whats_the_answer_score_eval	web_questions		whats_the_answer_score_eval
wiki_bio_comprehension	wiki_bio		comprehension
wiki_bio_comprehension_score_eval	wiki_bio		comprehension_score_eval
wiki_bio_guess_person	wiki_bio		guess_person
wiki_bio_guess_person_score_eval	wiki_bio		guess_person_score_eval
wiki_bio_key_content	wiki_bio		key_content
wiki_bio_key_content_score_eval	wiki_bio		key_content_score_eval
wiki_bio_what_content	wiki_bio		what_content
wiki_bio_what_content_score_eval	wiki_bio		what_content_score_eval
wiki_bio_who	wiki_bio		who
wiki_bio_who_score_eval	wiki_bio		who_score_eval
wiki_hop_original_choose_best_object_affirmative_1	wiki_hop	original	choose_best_object_affirmative_1
wiki_hop_original_choose_best_object_affirmative_1_score_eval	wiki_hop	original	choose_best_object_affirmative_1_score_eval
wiki_hop_original_choose_best_object_affirmative_2	wiki_hop	original	choose_best_object_affirmative_2
wiki_hop_original_choose_best_object_affirmative_2_score_eval	wiki_hop	original	choose_best_object_affirmative_2_score_eval
wiki_hop_original_choose_best_object_affirmative_3	wiki_hop	original	choose_best_object_affirmative_3
wiki_hop_original_choose_best_object_affirmative_3_score_eval	wiki_hop	original	choose_best_object_affirmative_3_score_eval
wiki_hop_original_choose_best_object_interrogative_1	wiki_hop	original	choose_best_object_interrogative_1
wiki_hop_original_choose_best_object_interrogative_1_score_eval	wiki_hop	original	choose_best_object_interrogative_1_score_eval
wiki_hop_original_choose_best_object_interrogative_2	wiki_hop	original	choose_best_object_interrogative_2
wiki_hop_original_choose_best_object_interrogative_2_score_eval	wiki_hop	original	choose_best_object_interrogative_2_score_eval
wiki_hop_original_explain_relation	wiki_hop	original	explain_relation
wiki_hop_original_explain_relation_score_eval	wiki_hop	original	explain_relation_score_eval
wiki_hop_original_generate_object	wiki_hop	original	generate_object
wiki_hop_original_generate_object_score_eval	wiki_hop	original	generate_object_score_eval
wiki_hop_original_generate_subject	wiki_hop	original	generate_subject
wiki_hop_original_generate_subject_and_object	wiki_hop	original	generate_subject_and_object
wiki_hop_original_generate_subject_and_object_score_eval	wiki_hop	original	generate_subject_and_object_score_eval
wiki_hop_original_generate_subject_score_eval	wiki_hop	original	generate_subject_score_eval
wiki_qa_Decide_good_answer	wiki_qa		Decide_good_answer
wiki_qa_Decide_good_answer_score_eval	wiki_qa		Decide_good_answer_score_eval
wiki_qa_Direct_Answer_to_Question	wiki_qa		Direct Answer to Question
wiki_qa_Direct_Answer_to_Question_score_eval	wiki_qa		Direct Answer to Question_score_eval
wiki_qa_Generate_Question_from_Topic	wiki_qa		Generate Question from Topic
wiki_qa_Generate_Question_from_Topic_score_eval	wiki_qa		Generate Question from Topic_score_eval
wiki_qa_Is_This_True_	wiki_qa		Is This True?
wiki_qa_Is_This_True__score_eval	wiki_qa		Is This True?_score_eval
wiki_qa_Jeopardy_style	wiki_qa		Jeopardy style
wiki_qa_Jeopardy_style_score_eval	wiki_qa		Jeopardy style_score_eval
wiki_qa_Topic_Prediction_Answer_Only	wiki_qa		Topic Prediction - Answer Only
wiki_qa_Topic_Prediction_Answer_Only_score_eval	wiki_qa		Topic Prediction - Answer Only_score_eval
wiki_qa_Topic_Prediction_Question_Only	wiki_qa		Topic Prediction - Question Only
wiki_qa_Topic_Prediction_Question_Only_score_eval	wiki_qa		Topic Prediction - Question Only_score_eval
wiki_qa_Topic_Prediction_Question_and_Answer_Pair	wiki_qa		Topic Prediction - Question and Answer Pair
wiki_qa_Topic_Prediction_Question_and_Answer_Pair_score_eval	wiki_qa		Topic Prediction - Question and Answer Pair_score_eval
wiki_qa_automatic_system	wiki_qa		automatic_system
wiki_qa_automatic_system_score_eval	wiki_qa		automatic_system_score_eval
wiki_qa_exercise	wiki_qa		exercise
wiki_qa_exercise_score_eval	wiki_qa		exercise_score_eval
wiki_qa_found_on_google	wiki_qa		found_on_google
wiki_qa_found_on_google_score_eval	wiki_qa		found_on_google_score_eval
wino_bias_type1_anti_What_does_p_stand_for	wino_bias	type1_anti	What does p stand for
wino_bias_type1_anti_What_does_p_stand_for_score_eval	wino_bias	type1_anti	What does p stand for_score_eval
wino_bias_type1_anti_Who_or_what_is_are	wino_bias	type1_anti	Who or what is/are
wino_bias_type1_anti_Who_or_what_is_are_score_eval	wino_bias	type1_anti	Who or what is/are_score_eval
wino_bias_type1_anti_by_p_they_mean	wino_bias	type1_anti	by p they mean
wino_bias_type1_anti_by_p_they_mean_score_eval	wino_bias	type1_anti	by p they mean_score_eval
wino_bias_type1_anti_refers_to	wino_bias	type1_anti	refers_to
wino_bias_type1_anti_refers_to_score_eval	wino_bias	type1_anti	refers_to_score_eval
wino_bias_type1_anti_replaced_with	wino_bias	type1_anti	replaced with
wino_bias_type1_anti_replaced_with_score_eval	wino_bias	type1_anti	replaced with_score_eval
wino_bias_type1_anti_represent	wino_bias	type1_anti	represent
wino_bias_type1_anti_represent_score_eval	wino_bias	type1_anti	represent_score_eval
wino_bias_type1_anti_the_pronoun_refers_to	wino_bias	type1_anti	the pronoun refers to
wino_bias_type1_anti_the_pronoun_refers_to_score_eval	wino_bias	type1_anti	the pronoun refers to_score_eval
wino_bias_type1_pro_What_does_p_stand_for	wino_bias	type1_pro	What does p stand for
wino_bias_type1_pro_What_does_p_stand_for_score_eval	wino_bias	type1_pro	What does p stand for_score_eval
wino_bias_type1_pro_Who_or_what_is_are	wino_bias	type1_pro	Who or what is/are
wino_bias_type1_pro_Who_or_what_is_are_score_eval	wino_bias	type1_pro	Who or what is/are_score_eval
wino_bias_type1_pro_by_p_they_mean	wino_bias	type1_pro	by p they mean
wino_bias_type1_pro_by_p_they_mean_score_eval	wino_bias	type1_pro	by p they mean_score_eval
wino_bias_type1_pro_refers_to	wino_bias	type1_pro	refers_to
wino_bias_type1_pro_refers_to_score_eval	wino_bias	type1_pro	refers_to_score_eval
wino_bias_type1_pro_replaced_with	wino_bias	type1_pro	replaced with
wino_bias_type1_pro_replaced_with_score_eval	wino_bias	type1_pro	replaced with_score_eval
wino_bias_type1_pro_represent	wino_bias	type1_pro	represent
wino_bias_type1_pro_represent_score_eval	wino_bias	type1_pro	represent_score_eval
wino_bias_type1_pro_the_pronoun_refers_to	wino_bias	type1_pro	the pronoun refers to
wino_bias_type1_pro_the_pronoun_refers_to_score_eval	wino_bias	type1_pro	the pronoun refers to_score_eval
wino_bias_type2_anti_What_does_p_stand_for	wino_bias	type2_anti	What does p stand for
wino_bias_type2_anti_What_does_p_stand_for_score_eval	wino_bias	type2_anti	What does p stand for_score_eval
wino_bias_type2_anti_Who_or_what_is_are	wino_bias	type2_anti	Who or what is/are
wino_bias_type2_anti_Who_or_what_is_are_score_eval	wino_bias	type2_anti	Who or what is/are_score_eval
wino_bias_type2_anti_by_p_they_mean	wino_bias	type2_anti	by p they mean
wino_bias_type2_anti_by_p_they_mean_score_eval	wino_bias	type2_anti	by p they mean_score_eval
wino_bias_type2_anti_refers_to	wino_bias	type2_anti	refers_to
wino_bias_type2_anti_refers_to_score_eval	wino_bias	type2_anti	refers_to_score_eval
wino_bias_type2_anti_replaced_with	wino_bias	type2_anti	replaced with
wino_bias_type2_anti_replaced_with_score_eval	wino_bias	type2_anti	replaced with_score_eval
wino_bias_type2_anti_represent	wino_bias	type2_anti	represent
wino_bias_type2_anti_represent_score_eval	wino_bias	type2_anti	represent_score_eval
wino_bias_type2_anti_the_pronoun_refers_to	wino_bias	type2_anti	the pronoun refers to
wino_bias_type2_anti_the_pronoun_refers_to_score_eval	wino_bias	type2_anti	the pronoun refers to_score_eval
wino_bias_type2_pro_What_does_p_stand_for	wino_bias	type2_pro	What does p stand for
wino_bias_type2_pro_What_does_p_stand_for_score_eval	wino_bias	type2_pro	What does p stand for_score_eval
wino_bias_type2_pro_Who_or_what_is_are	wino_bias	type2_pro	Who or what is/are
wino_bias_type2_pro_Who_or_what_is_are_score_eval	wino_bias	type2_pro	Who or what is/are_score_eval
wino_bias_type2_pro_by_p_they_mean	wino_bias	type2_pro	by p they mean
wino_bias_type2_pro_by_p_they_mean_score_eval	wino_bias	type2_pro	by p they mean_score_eval
wino_bias_type2_pro_refers_to	wino_bias	type2_pro	refers_to
wino_bias_type2_pro_refers_to_score_eval	wino_bias	type2_pro	refers_to_score_eval
wino_bias_type2_pro_replaced_with	wino_bias	type2_pro	replaced with
wino_bias_type2_pro_replaced_with_score_eval	wino_bias	type2_pro	replaced with_score_eval
wino_bias_type2_pro_represent	wino_bias	type2_pro	represent
wino_bias_type2_pro_represent_score_eval	wino_bias	type2_pro	represent_score_eval
wino_bias_type2_pro_the_pronoun_refers_to	wino_bias	type2_pro	the pronoun refers to
wino_bias_type2_pro_the_pronoun_refers_to_score_eval	wino_bias	type2_pro	the pronoun refers to_score_eval
winograd_wsc_wsc273_GPT_3_Style	winograd_wsc	wsc273	GPT-3 Style
winograd_wsc_wsc273_GPT_3_Style_score_eval	winograd_wsc	wsc273	GPT-3 Style_score_eval
winograd_wsc_wsc273_Who_or_what_is_are	winograd_wsc	wsc273	Who or what is/are
winograd_wsc_wsc273_Who_or_what_is_are_score_eval	winograd_wsc	wsc273	Who or what is/are_score_eval
winograd_wsc_wsc273_by_p_they_mean	winograd_wsc	wsc273	by p they mean
winograd_wsc_wsc273_by_p_they_mean_score_eval	winograd_wsc	wsc273	by p they mean_score_eval
winograd_wsc_wsc273_does_p_stand_for	winograd_wsc	wsc273	does p stand for
winograd_wsc_wsc273_does_p_stand_for_score_eval	winograd_wsc	wsc273	does p stand for_score_eval
winograd_wsc_wsc273_does_the_pronoun_refer_to	winograd_wsc	wsc273	does the pronoun refer to
winograd_wsc_wsc273_does_the_pronoun_refer_to_score_eval	winograd_wsc	wsc273	does the pronoun refer to_score_eval
winograd_wsc_wsc273_p_is_are_r	winograd_wsc	wsc273	p is/are r
winograd_wsc_wsc273_p_is_are_r_score_eval	winograd_wsc	wsc273	p is/are r_score_eval
winograd_wsc_wsc273_replaced_with	winograd_wsc	wsc273	replaced with
winograd_wsc_wsc273_replaced_with_score_eval	winograd_wsc	wsc273	replaced with_score_eval
winograd_wsc_wsc273_the_pronoun_refers_to	winograd_wsc	wsc273	the pronoun refers to
winograd_wsc_wsc273_the_pronoun_refers_to_score_eval	winograd_wsc	wsc273	the pronoun refers to_score_eval
winogrande_winogrande_debiased_Replace	winogrande	winogrande_debiased	Replace
winogrande_winogrande_debiased_Replace_score_eval	winogrande	winogrande_debiased	Replace_score_eval
winogrande_winogrande_debiased_True_or_False	winogrande	winogrande_debiased	True or False
winogrande_winogrande_debiased_True_or_False_score_eval	winogrande	winogrande_debiased	True or False_score_eval
winogrande_winogrande_debiased_does_underscore_refer_to	winogrande	winogrande_debiased	does underscore refer to
winogrande_winogrande_debiased_does_underscore_refer_to_score_eval	winogrande	winogrande_debiased	does underscore refer to_score_eval
winogrande_winogrande_debiased_fill_in_the_blank	winogrande	winogrande_debiased	fill in the blank
winogrande_winogrande_debiased_fill_in_the_blank_score_eval	winogrande	winogrande_debiased	fill in the blank_score_eval
winogrande_winogrande_debiased_stand_for	winogrande	winogrande_debiased	stand for
winogrande_winogrande_debiased_stand_for_score_eval	winogrande	winogrande_debiased	stand for_score_eval
winogrande_winogrande_debiased_underscore_refer_to	winogrande	winogrande_debiased	underscore refer to
winogrande_winogrande_debiased_underscore_refer_to_score_eval	winogrande	winogrande_debiased	underscore refer to_score_eval
winogrande_winogrande_xl_Replace	winogrande	winogrande_xl	Replace
winogrande_winogrande_xl_Replace_score_eval	winogrande	winogrande_xl	Replace_score_eval
winogrande_winogrande_xl_True_or_False	winogrande	winogrande_xl	True or False
winogrande_winogrande_xl_True_or_False_score_eval	winogrande	winogrande_xl	True or False_score_eval
winogrande_winogrande_xl_does_underscore_refer_to	winogrande	winogrande_xl	does underscore refer to
winogrande_winogrande_xl_does_underscore_refer_to_score_eval	winogrande	winogrande_xl	does underscore refer to_score_eval
winogrande_winogrande_xl_fill_in_the_blank	winogrande	winogrande_xl	fill in the blank
winogrande_winogrande_xl_fill_in_the_blank_score_eval	winogrande	winogrande_xl	fill in the blank_score_eval
winogrande_winogrande_xl_stand_for	winogrande	winogrande_xl	stand for
winogrande_winogrande_xl_stand_for_score_eval	winogrande	winogrande_xl	stand for_score_eval
winogrande_winogrande_xl_underscore_refer_to	winogrande	winogrande_xl	underscore refer to
winogrande_winogrande_xl_underscore_refer_to_score_eval	winogrande	winogrande_xl	underscore refer to_score_eval
wiqa_does_the_supposed_perturbation_have_an_effect	wiqa		does_the_supposed_perturbation_have_an_effect
wiqa_does_the_supposed_perturbation_have_an_effect_score_eval	wiqa		does_the_supposed_perturbation_have_an_effect_score_eval
wiqa_effect_with_label_answer	wiqa		effect_with_label_answer
wiqa_effect_with_label_answer_score_eval	wiqa		effect_with_label_answer_score_eval
wiqa_effect_with_string_answer	wiqa		effect_with_string_answer
wiqa_effect_with_string_answer_score_eval	wiqa		effect_with_string_answer_score_eval
wiqa_what_is_the_final_step_of_the_following_process	wiqa		what_is_the_final_step_of_the_following_process
wiqa_what_is_the_final_step_of_the_following_process_score_eval	wiqa		what_is_the_final_step_of_the_following_process_score_eval
wiqa_what_is_the_missing_first_step	wiqa		what_is_the_missing_first_step
wiqa_what_is_the_missing_first_step_score_eval	wiqa		what_is_the_missing_first_step_score_eval
wiqa_what_might_be_the_first_step_of_the_process	wiqa		what_might_be_the_first_step_of_the_process
wiqa_what_might_be_the_first_step_of_the_process_score_eval	wiqa		what_might_be_the_first_step_of_the_process_score_eval
wiqa_what_might_be_the_last_step_of_the_process	wiqa		what_might_be_the_last_step_of_the_process
wiqa_what_might_be_the_last_step_of_the_process_score_eval	wiqa		what_might_be_the_last_step_of_the_process_score_eval
wiqa_which_of_the_following_is_the_supposed_perturbation	wiqa		which_of_the_following_is_the_supposed_perturbation
wiqa_which_of_the_following_is_the_supposed_perturbation_score_eval	wiqa		which_of_the_following_is_the_supposed_perturbation_score_eval
xsum_DOC_boils_down_to_simple_idea_that	xsum		DOC_boils_down_to_simple_idea_that
xsum_DOC_boils_down_to_simple_idea_that_score_eval	xsum		DOC_boils_down_to_simple_idea_that_score_eval
xsum_DOC_given_above_write_one_sentence	xsum		DOC_given_above_write_one_sentence
xsum_DOC_given_above_write_one_sentence_score_eval	xsum		DOC_given_above_write_one_sentence_score_eval
xsum_DOC_how_would_you_rephrase_few_words	xsum		DOC_how_would_you_rephrase_few_words
xsum_DOC_how_would_you_rephrase_few_words_score_eval	xsum		DOC_how_would_you_rephrase_few_words_score_eval
xsum_DOC_tldr	xsum		DOC_tldr
xsum_DOC_tldr_score_eval	xsum		DOC_tldr_score_eval
xsum_DOC_write_summary_of_above	xsum		DOC_write_summary_of_above
xsum_DOC_write_summary_of_above_score_eval	xsum		DOC_write_summary_of_above_score_eval
xsum_article_DOC_summary	xsum		article_DOC_summary
xsum_article_DOC_summary_score_eval	xsum		article_DOC_summary_score_eval
xsum_college_roommate_asked_DOC_so_I_recap	xsum		college_roommate_asked_DOC_so_I_recap
xsum_college_roommate_asked_DOC_so_I_recap_score_eval	xsum		college_roommate_asked_DOC_so_I_recap_score_eval
xsum_read_below_DOC_write_abstract	xsum		read_below_DOC_write_abstract
xsum_read_below_DOC_write_abstract_score_eval	xsum		read_below_DOC_write_abstract_score_eval
xsum_summarize_DOC	xsum		summarize_DOC
xsum_summarize_DOC_score_eval	xsum		summarize_DOC_score_eval
xsum_summarize_this_DOC_summary	xsum		summarize_this_DOC_summary
xsum_summarize_this_DOC_summary_score_eval	xsum		summarize_this_DOC_summary_score_eval
yelp_review_full_based_on_that	yelp_review_full		based_on_that
yelp_review_full_based_on_that_score_eval	yelp_review_full		based_on_that_score_eval
yelp_review_full_format_rating	yelp_review_full		format_rating
yelp_review_full_format_rating_score_eval	yelp_review_full		format_rating_score_eval
yelp_review_full_format_score	yelp_review_full		format_score
yelp_review_full_format_score_score_eval	yelp_review_full		format_score_score_eval
yelp_review_full_format_star	yelp_review_full		format_star
yelp_review_full_format_star_score_eval	yelp_review_full		format_star_score_eval
yelp_review_full_on_a_scale	yelp_review_full		on_a_scale
yelp_review_full_on_a_scale_score_eval	yelp_review_full		on_a_scale_score_eval
yelp_review_full_so_i_would	yelp_review_full		so_i_would
yelp_review_full_so_i_would_score_eval	yelp_review_full		so_i_would_score_eval
yelp_review_full_this_place	yelp_review_full		this_place
yelp_review_full_this_place_score_eval	yelp_review_full		this_place_score_eval
